13111111111
10100000001
10111110101
10140010101
10101011101
10001000001
11111111101
10000000001
10111111111
10000000001
11111511111

R
