11111111111
10000000005
11111111101
10000000101
11111010101
30000010141
10111111101
10100010001
10101010111
10001000001
11111111111

U
