11111511111
10100004001
10101110101
10100010101
10111010111
10101010001
10101011101
10100010001
10111110101
10000000101
13111111111

L
