11111113111
10001000101
11101010101
10100010001
10111111101
10001000001
10101011111
10101010001
10111010101
10000400101
11111115111

R
