11111111111
50001000001
11101010111
10001010001
10111111101
10100000103
10111014101
10001010001
11101011101
10000010001
11111111111

U
