11111115111
10000000001
11111111101
10000000101
11101111101
10001000101
10111010101
10001010101
10101010101
10100010041
13111111111

U
