11111311111
10000010001
11111010101
10001014101
10111010101
10100010101
10101110101
10001000101
10111011101
10000010001
11111115111

U
