11111111111
10100000001
10111110111
34100010001
10101010101
10001010101
11111010101
10001010105
10111011101
10000000001
11111111111

D
