11111111111
10100000001
10111111101
10100000001
10101111101
30401000105
11111011101
10001000101
10111010101
10000010001
11111111111

R
