11111111111
50100000101
10101110101
10101010101
10101010101
10001010403
11111011101
10001000101
10101010101
10100010001
11111111111

L
