11131111111
10100000001
10101110101
10101000101
10111011111
10001014001
11101010101
10101000101
10101111101
10000000001
11151111111

R
