11111113111
10100004001
10111010101
10001010101
11101110101
10100010101
10111010101
10100010101
10101110101
10000000101
11111115111

D
