11111111111
10100000105
10101110101
10100410101
10101010101
10101010101
10111010101
30100010101
10101110101
10001000001
11111111111

L
