13111111111
10100010001
10101110101
10100000101
10111111101
10000000101
11111114101
10100000101
10101111101
10000000001
11111115111

D
