11111111111
10100010001
10101011101
30001010001
11111410101
10000010101
10111110101
10100000105
10111011101
10000010001
11111111111

D
