11111111111
50100010003
10101010101
10101000101
10111111101
10000004001
11111111101
10000000101
10111111101
10000000001
11111111111

L
