11111111111
10100010001
10101011101
50001010001
11111010101
10000010103
10111110111
10100010001
10101011141
10001000001
11111111111

D
