13111111111
10100000101
10111014101
10000010001
11111111101
10001000001
10101011111
10100010001
10111111101
10000000001
15111111111

D
