11111111111
10001000003
11101110101
50101000101
10101011101
10101010101
10101010101
10100010101
10111110101
10000000401
11111111111

L
