15111111111
10100000001
10111111101
14000000101
11111110101
10100010001
10101011101
10001000101
10111110101
10000010001
13111111111

U
