11111113111
10001004001
11101110101
10101000101
10101011101
10101010001
10101010111
10001010101
10111010101
10000010001
15111111111

D
