11111511111
10100000101
10101014101
10101010001
10111011101
10100010101
10101110101
10001010001
11111010111
10000000001
11131111111

U
