11111113111
10100000101
10101110101
10001010001
11111011101
14000000001
10111111111
10100000001
10101111101
10001000001
11151111111

D
