15111111111
10001010001
11101010101
14001000101
10111011101
10100000101
10101111101
10101000101
10111010101
10000010001
11111311111

R
