11111111111
50100000001
10101111101
10101000003
14101011111
10101010001
10111010101
10001000101
11101111101
10000000001
11111111111

U
