11111511111
10000010001
11111010101
10001010101
10111010101
10000010101
10111110101
10000000141
11111111101
10000000001
11111113111

U
