11111111111
10100000005
10101111101
10100010001
10101011101
30101000101
10111114101
10000000101
11111111101
10000000001
11111111111

U
