11111111111
10100000001
10111111101
10000000003
11111111101
10100010001
10101010111
50141000101
10101111101
10000000001
11111111111

D
