13111111111
10100010001
10101011101
10001004101
11111110101
10000000101
10111111101
10100000101
10101110101
10001000001
11111115111

D
