11151111111
10100010001
10101010101
10101000101
10111011101
10001010101
11101010101
10001000101
10111111101
10000004001
11111113111

R
