11151111111
10001000001
11101111101
10101000001
10101011111
10101000001
10101111101
10100000401
10111111101
10000000001
11131111111

L
