11111111111
10100000001
10101011101
10101000101
10111110111
10100010003
10101011101
50101040001
10101111101
10001000001
11111111111

L
