13111111111
10100010001
10111010101
10001000101
11101011101
10001000101
10111111101
10100000001
14111011101
10000010001
11111511111

D
