11111111111
10100000101
10111010101
10000010105
11111110101
10000010101
11101010101
34001010001
10111111101
10000000001
11111111111

D
