11111111111
10000000001
11111111101
10000010001
10101010111
10101010105
10101110101
30104010101
10111010101
10001000001
11111111111

R
