11111311111
10001000001
11101011101
10001000101
10111110101
10100000101
10101111101
10001010041
11111010111
10000000001
11151111111

L
