11111111111
10100000001
10111011101
50001010101
11101010101
10001010101
10111010101
10041000103
11101111101
10000000001
11111111111

L
