11111111111
10100000005
10111110101
10140000101
10101111101
30101000101
10101010101
10001010101
11111010101
10000010001
11111111111

R
