11111111111
10000010001
11111010101
50001010101
10111010101
10000014101
10111110101
10100000103
10111011101
10000010001
11111111111

D
