11131111111
10100400101
10101110101
10001000101
11111011101
10001010001
10101011101
10101000001
10101111101
10100000001
11111511111

R
