11111111111
10001000001
11101011101
10101000101
10101011101
50101010003
10101110101
10100000101
10111111101
10000000041
11111111111

L
