11131111111
10100000001
10101110111
10100010001
10111111101
10100400001
10101111101
10100000101
10111110101
10000000101
15111111111

L
