11111111111
10001000001
11101010111
10001010001
10111110101
10100010101
10101011101
30001000105
11111110101
10000004001
11111111111

R
