13111111111
10100000001
10111111101
10000040101
11111110101
10000010001
10101111101
10101000001
10101011111
10100000001
15111111111

R
