111111111111111311111111111111111111111111111111111
101000000000000014000000000000001000100000001000001
101111101011101110111111101011101010101011101110101
100000101010001000101000101010001010001000100010101
111110111011111011101010111010111111101110111010101
100010001000001000001010001010000000100010001010101
101011101110101111101011101011111110111111101011101
101000100010101000101010101010000010100010001000101
101110111010101010101010101010111010101010111110101
100010000010100010001010001010101010001010001010001
111011111111111110111010111010101011111011101011101
100010100000000010100010000010101010001010001000001
101110101110111011101111111010101010111010111011111
101000001000101000001000000010001010100010101000001
101111101011101111101111111011101010101110101111101
100000101000100000001000001010101010000000100000001
111110101110111111111011101010101011111111101111111
101000101000100000100010101000101000100010100010001
101011111011101110101110101110101110101010111011101
100010000010001010001000100010100010001010001010001
101110101110111011111011111010111011111010101010101
101000100010100000001000001010001010001010101000101
101011111010101110101110111011111010111010101111101
101010001000101000100010100010000000100010100010001
101110101110111011111010101110111111101110111110111
100010100010100010001000100000100000101000000010101
111010111010101110101110111111101110101111101010101
101000100010001000100000001000101000100000101010001
101111101111111011111111111010101011111110111011101
100000100000100010001000001010001010000000100010001
101111111110101110101011101011111010111111101010111
101000000000100010101000101010100010100000001010101
101011111111101110101110101010101110101110111010101
101000100000001000100010100010001000100010100010001
101110101111111011111010111111101011111010111111101
100000100010000010100010100000100010100010000000001
101111111010111110101110101110111110101111111111111
101000001010000010101000000010001000001000000010001
101110101110111010101011111111101011111010111010111
100010100010100010001010001000001010000010101010001
111010111011101110111010101011111011111110101011101
100010001000001010100010100010001000001000100010001
101111101111111010111110111110111111101011101110111
101000001000001000100000101000000000001000101000001
101010111010111011101111101011111111111110101110101
101010100010001000101000100000100010000000100010101
101010111011101110101010111110101010111111111010101
101010001010101000100010001010001000100000100010101
101111101010101011111111101011111111101110101111101
100000001000100000000000001000000000000010000000001
111111111111111115111111111111111111111111111111111

R
