111111111111111111111111111111111111111111111111111
100000000010001000000000001010000000000000000000101
111111111010111011111011101010111111101111111110101
100000101010000010001010101010100010100010000000101
101110101011111010101010101010101010111010111111101
101010101000001000101010001000001000101010000000101
101010101111101111111010111111111110101011111110101
101000001000100000000010000010100010001000000010101
101111101110111111111111111010101011101111111010101
101000100000100000000000001010001000001000000010001
101010111110101010111111111010111110111011111111101
100010100000101010100000100010100010100010001000001
101110111110101011101110101110101011101111101011111
501000100010101000001010001000101010001000001000001
101010101010101111111011111011101010111011111111101
101010101010101010000010000000101010101000000000101
101011101011101010101110111111101010101011111011101
101010001000101000100010100010001010101010001000001
101010111110101011111010101110111010101010101111111
101010101000101000001000001000101010100014101000001
101010101010101111111110111011101010101110101110101
101000101010100000000010100010001000101000100000103
101111101010111111111011101111101111101011111011111
100010001010100000001000101000001000101010000010001
111010111010101010111110101011101011101010111110101
100000100010101010100010001000100010001010001000101
101111101110101011101011111110111110111011111011101
101000101010101000001000000010000010100000000010001
111010101010111011111011111011111010111110111110101
100010001000001000001010001000000010100010001010101
101111101111101111111010101111111010101011101010111
101000001000100010000010101000000010001000101010001
101111111010111010111110111011111111111110101011101
100000000010001010001010000010000010001000100000101
101111111111101010101010111110111010101011111111101
100010001000101010101000100000100010101010000000001
111010111010101011101011101111101110101010111111101
100010000010101000101010001000100000101000101000001
101110111110101110101010111110111111101111101011111
101010100010100010001000100010000000100000001000101
101010111010111011111011101010111010111111101110101
101010100010001010100010001010001010001000000010001
101010101111101010101110111011111011111011111111101
101000001000001010001000101000001000000010000010001
101111111011111010111011101111101011111110111010111
100000001000001010001010000010001000101000101010001
111111101111101011101011111010111110101011101011101
100000101000101000101000100010100000001000001000101
101111101010101110111110101010111111111111101110101
100000000010000010000000001010000000000000000010001
111111111111111111111111111111111111111111111111111

D
