111111111111111111111111111111111111111111111111111
100010000000100000000010000000000010000000001000001
111011111010111111101011101111111011111110101110101
101000000010001000001000001000001000000010101000105
101111111111101011111111111011101111111010101011111
100000000000101000100000001000100000001000101010001
101111101111101110111011101110111110111111101010101
100000101000001000100010100010000010000000101000101
101111101011111011101110111011111011111110101011101
101000001010100010001000001010001000100010001000101
111011111010101010111010111011101110111011111110101
100010000010001010100010000010000010000010000010101
101110111111111010111111101110111111111011111010101
100010000000000010000000100010000000100010001000101
111011111111111111111110111011101110101110101111101
100000100000100000000010101000101000101000100000101
101110101010101110111010101110111010101010111110101
100010101010100010100000100000001010101010001010001
101010111011111010111111111111101010101011101011101
101010001010000410001000000000100010101010001010001
101011101010111111101011111110111110101110111010111
301010000010001000101010001010100010100000100010001
101011111111101110101010101010101010111111111011101
101000100000001000101000101010001010001000000000101
101110101111111010101111101011111011101111101110101
100010001000000010100000101000100010000000001000101
111011111110111111101110101010101110111111111011101
101010000010100000101000100010100010100000100000101
101010101010101110101111111110111011101110111110101
100010101000101010001000000010001000100010001000101
101111101111101011101011111011101110111011101110101
101000100010001000001010001000100010001010100010101
101010111010111111101010101011101110111010111011101
101010000010000000101000101000101000100010001010001
101011111011111110111111101110101010101110111010111
100010000010000010000000100010101010100010001010001
111110111111111011111011111010101011111010101011101
100000100000000010000010000010001000100010101000101
101111101111111010111110111111111110101111101011101
100000100010000010001000100000000010001000001000001
111110111011101111101011111111101011111110101111111
100010001000101000101010000000101000000000101000001
101111101010101011101010111110101111111111101111101
100000001010101010001000100010001000100010001000001
101111111110101010111111111011111010101010111011111
101000000000100010100000000010000010001010100000001
101111111011111010101011111110111111111010111111101
100000001000100010001000100010001000001010000010001
111111101110101111111110101011101011101011111010101
100000000000100000000010001000000010001000000000101
111111111111111111111111111111111111111111111111111

U
