111111111111111111111115111111111111111111111111111
101000001000000010000000100000100000001000000000101
101110111011101011111010101110101111101011111010101
100010000010001010000010001010001000001000100010001
111011111110111010111111111011111011111110101111111
101000000000100010000000100000000010000000100000001
101111111111101111111110111011111110111111111111101
101000001000100000000010001010001010000000100000101
101011101010111111111011101010101011111110101110101
100010100010001000001010001000101000000010001010101
101110111110101011101010111111101010111111111010101
101000000010100010001000100010001010100010000010101
101111101010111110111111101010111010101010111010101
100010001010001010000010001000100010001000001000101
111010101111101010111110111111101111111111111110101
100000101000001010100000100010001000000010000010101
101111111011111010101111101010111010111010111011101
101010001010001000101010001010100010001010100000001
101010101010101111101010111010111111101010111111101
101010101010100000101010101000100000101010000010101
101010101010111110101010101111101110101111111010101
100010101010100010001000100000001010100000100010101
111010101010111011111011101011111010111011101110101
100010100010000010000010001000100000000010001000001
101110111011111011111011101110111011111110111011111
100010001010001010001000100010001010000000101000001
111011101110101010101110111111101010111111101111101
101000100010101000100010001000001010100000100000001
101110111010101111111011101011111010101110101111111
100010001000100000100010101000100010101000100000101
101011101111111011101110101110101110101011111110101
101000001000001000101000100010101000101000000010101
101111101110101110101110111010101011111011101110101
101000100000100010100010000000101010001000100010001
101010101111111110111011111111101010101011111011101
101010101000000000001000001000001000101010001000001
111010111011111011111111101011111111101110101011111
100010001000100010000000001010000000101000101010001
101111101110101110111111111010111110101011101011101
100000100000100010100000001000101000100010001000001
101110111110111110101011111111101011111110111111111
101010001010100000101010000000001000101000100000001
101011101010101111101010111011111110101011101111101
101000101010100010001000100010000010001000001000101
101010101010111011111111101010101111101111111010101
100010101000101010000000101010100010001000100010001
111110101011101010111110101110111010111010101111101
100010101000001000100010100000001000100010100010101
101010101111111111101010111111111111101110111010101
101000100000000000001000000000000040001000000010001
111111111111111111111111111111111111111113111111111

L
