111111111111111111111111111111111111111111151111111
101000100010000010000000000010001000000000000010001
101010101010111010111110111010101010111111111010101
101010001000100010101000100010100010001010001000101
101011111011111010101011101110111111101010101111101
101010001010001010101000100010100000001010100000001
101010101110101110101110111011101111111010111111111
101000100000101000001000100010001000001010000010001
101011111111101011111011101110111010101011111010101
101000100000100010000010001000001010100010001010101
101110111010111110111110111011101110111010101010101
100010001010001010001010100000100010100010101000101
111011101110101011101010111111111010101110101111101
100010001000101000101010000010000010101010100000001
101110111011101110101011111010111110101010111111111
101010000010100000101000100010100000101010001000101
101011111110111011101110101110111011101011101010101
101000100010000010001000101000001010000000100010001
101110101010111110111011101011101011111110111111101
100010101000100010001010001010001000000010001000101
111010101111101011101010111010111011111011101010101
100010000000101000001010100010100010000010100010101
101111111111101111111010111110111010111110111011101
101000001000001000000010000010001010100010001010001
101011101011111011111011111011101010101010101010111
101010001000101010100010001000001010001010100010001
101010111010101010101110101111111011111011111111101
101010001010100000100000100000000010001010000000101
101011101010111110111111111111111110101010111110101
101010101010001000001000000000100010100010001010001
101010101111101111101110111110101010101111101011111
100010100000100000100000100010101010101000100010001
111110111110111010111111101011101010101010111010101
100000000010001010000010001000101010101010100010101
101111111011101111111010111110101010101410101110101
101000100010100000100010001010101000101010001000101
111010101010111110101111101010101111101011111111101
100010001000100010001000001000001000101000100000001
101111111110101011111110111111111010101110101111111
100010000010101000100000100010000010101010100000001
111010101110101010101110101010111110101010101111101
100010100000101010001000101000100010101010100000101
101110111111111011111111101111101110101010101111101
100010000010000010000000001000001000100010101000001
101011111010101110111111111111101011111110111011101
101000001010101000100000001000001000000010001010101
101111101010111011101011101011101111111011101010101
100000101000100010001010101010101010000000100010101
111110101111101111111010101010101010111111111110101
100000100000000000000010000010000010000000000000001
111111111111111111111111131111111111111111111111111

U
