111511111111111111111111111111111111111111111111111
100010000000000010000000100000001000000010000000001
111011111010111011111010101011101011111011111110101
101000001010001000000010101010000010001010000010101
101111101011101011111111101011111110101010111010101
101000001000101010000000001000001000101000101010101
101011111110101110111111111111101010111111101011101
101010000010101000101000000000101010000000100010001
101011101011101011101010111110101011111011101110111
101010001010001010000010000010101000100010001000001
101010111010111010111111111011101110101110111111101
101000101010000010000010000010001000100000000000001
101111101010111110111110111010111011111111111111101
100010000010100000100000101010001010000000100010001
101110111110101111101111101011101011111011101011111
101000100010100000101000000010101000000010001000001
101011101010111111101011111110101111111010111111101
101000101010000000001000000000100000100010100000001
101110101111101111111111111110111110111110101111101
100000100000001000100000001000101000100010100000101
101111101111111010101111101011101011101010111110111
101000000000100010100010001000101010001000000010001
101111111111101110111011111110101010111111111111101
100000000000001000100010000000001000000010000000001
111111111111111011101110111111111111111010111111101
100000100000000010001000100000100010001010101000001
111011101111111110111011101110101010111010101011111
100010001000000010000000101000101010000010100000001
101010111011111010111111101011101010111110111111101
101010001000001010100000001000001010000010000000101
101011101110101011101111111111111011111111111110101
101000100010101000001000000000100010000000000010101
101111111410101111111011111110101110111111111010101
101000100010100010100000100010100010100010000010101
101010101111111010101110101010111010101011101110101
101010100000000010100010001010001010001000101000101
101010111111111110111011111010111010111110101010101
100010000000101000000010000010100010100000101010101
101111101110101011111110111110101111101111101110101
100000101010001000100010000010100000101000100010101
111110101011101110101111111010111110101010111010101
100010101000100010100000100010100000100010101000101
101011101010111010101110101111101111111110101111101
101000101010000010101000100000101000100000100010001
101110101111111110101011111110101010101111101010111
101000001000001000101010000010101010101010001000101
101111111011101011101010111010101010101010111111101
100000100010001000101010100000101010001010100000001
101110101110111110111010111111101011111010111110101
100010000010000000000010000000000010000000000000101
111111111111111111111111111111131111111111111111111

U
