111111111111111111111111111111111111111111111111111
301000000000100010001000001000001000000000100000001
101111101110101011101010101011101011111010101111101
100000101010001000101010101000101010001010101010001
111110101011111110101010101110101010101011101010111
100010101000000000100010101000101010101000001010005
101010101111111011111010101011101010111111101011101
101010100000001000001010101010001010100000101000101
101110101111101111101110101010111010101110101110101
101000100000101000100000101010001000101000100000101
101011111111101010111111101011101110101110111111101
101000100000001010001000001000100000100010000000101
101110101111111111101011111111111011111011111110101
100010101000100000001010000010001000100010000010001
101110101010101111101010111010101111101110101011101
100010100010101000101010101000100000001000101000101
101010101110101010111010101111111111111011101110101
101010101010100010100010100010000010000010100010101
101010101010111110101110101110101110111110111010101
101010100010100010101000100000100000000000100010101
111010111110101010101010101111111111101111101011101
100010000010001010001010101000000000101000001010001
101111111011111011101110101010111110111011101110111
100000001000001000101000101010100010100010001000101
101110111111101110101011111010101010101111111011101
101010000000001000100010000010101010001000000010001
101011111111111011111110101110101011111011111111101
100010000000000010001000101010101000000010000000001
111011111011111110101011101010101111111110111111111
101010000010001010101010101000101000001000000000001
101010111110101010101010101111101010101011111111101
101010000010101010101000100000001010101010000000101
101010111010101010101110111111111010101011101111101
100010001000101000101000100010001010101000001000001
101111111011101110101011101010101010111111101011101
100010001000100010100000001000101010000010001010101
111010101110111010111111111111101011111010111010101
100010100010101010100010000004101010001000100010101
101110111010101010101010111110101010101111101110101
101000101010001010101000100000101010100010001000101
101011101010111010101111101111101010101110111011101
101000100010100010101000100010001010100010001000101
101010101110101111101010111010111011101011101010101
101010100010100010000010001010001000101010001010001
101110111011101010111111111011101110111010111011111
100010100000101010001000001000100010000010101000101
111010111110111011101011101010111011111110101110101
100010001010001000001010101010001000100000100010101
101111101011101111111010101111101110101111101110101
100000001000000000000010000000001000001000000000001
111111111111111111111111111111111111111111111111111

L
