111111111111111511111111111111111111111111111111111
100000001000000010000010000000000010001000001000001
111111101011111110101110101111101110101010101111101
100000101000000010100000101000101000100010100000001
101110101011111010111111101110101011111110111111101
101000101010001000100000100010101010001000100000001
101110101110101111101110111010101011101011111110111
100010100000100000001010100010001010001000000010001
111010111111111111111010101110111010101111111011101
100010000010000000001000101010001010101000001010001
101111111110111110111011101011101010101111101011101
101000000010000010000010001000001010100010001000101
101011111011111011111110111111111010111010101110101
100010001000001010000010000010000010001000100010101
101110111011101010111010111010111111101011111110111
100010001010001000100010001000100000001010000010001
111011101011111111101111101111101110111110111010101
101000001010000000100000100000001000100000100010101
101111101010101011111110111111111011101111101111101
100000101000101010000010001000000000101000101000001
101111101111101110111011101111111111101110101010101
101000001000001000001000100000000000001000101010101
101011111010111011111110111111111111111011101010101
100010000010100010100000000000000000001000001010141
101110101111101110101011111111111111101011111110101
100010101000000000101010000010000010001010000000101
111010111011111111101010111010111011101010111111101
100010000010001000001010001010101000101000100000101
101111111010101011111011101010101110101111101010101
101000001000101000001000101000100010100000101010101
101011101111111111101110101111111010111110111011101
101000100000000000001010101000100010000010000010001
101110111110111111111010101010101111111011111010111
100010100000100010100010100010101000001000001010101
111010111011101010101010111110101010101111101110101
101010001010001010001000000010100010100000100010101
101011101110111010111111111110101110111110111010101
101000100010101010100000000000101010000010001010101
101110111010101011101111111111101011111010111010101
100010101010001000100010000000101010001010100010001
101010101011101110111011101111101010101011101111101
101000101000101000001000100000101000101000100000001
101111101110101011111110111010101111101110111111111
100000000010001010000010001010000010000010000000001
111111111011111010111011101111111010111011111110101
100000001000101010001000001000001010001010001000101
101111111110101011101111111011101011101110101011101
101000000010101000101000100010001000001000101010101
101011111010101011101010101110111111111011101010101
100000001000001000000010001000000000000010000010001
111111111111111111111311111111111111111111111111111

U
