111111111111111111111111111111111111111111111111111
100000000010000010001000000010000000000000001000001
111111111011101011101010111011111010111111101010111
100000001000001000100010101000001010000000101010001
101011111111111110111110101111101111101110101111101
101010000010000010001000101000100000101010101000101
101010101011101111101011101010111110101010101010101
101000101000001000101000100010000010100010100010001
101111101111101010101110101111101110111110111111101
100000101010001010001000100000100010100010001010001
111110101010111011111011111110111010101011101010111
100000101000100010000010000010001000101000001010101
101111101011101111111011111011101111101111111010101
101000101000100000001000100000100000001000000010001
101010101110111111101110101111111111111110111111101
101010001000000000101000101000001000000000100000101
101011111011111111101011101011101011111011101010101
101000100000100000100010001000100010100010001010101
101110111111101110111110101110111110101010111011101
100010000000100010100000100010000010101010001000001
111011111110111010101011111011111010101111101111111
101010000010000010101000001010001000100000100000001
101010111011111110101111101011101110111011111111101
100000100000000010100010001000101000101000000000001
111111111111111110111010111110101011101111111111111
100010000000000010001010100000001000001000000000003
101010111111111010111010111111111111101111111111101
101000100000100010000010100000100000001000100000101
101111101111101111111110101110101111111010101110101
101000100010001000000000100010001000400010001000101
101110101010111010111111111011111010111111111110101
500010101010100010100000001000100010100000100010101
111010101010111010101111101110101011101110101010101
100010001010001010100010100000101000101010001010001
101111101011101011111010111111111010101011111011101
100000101000001010000010000000001010001000001000101
111110101111111010111111111011101011111111101110101
100000101010000010001000100010001000100000000010101
101111101010101011101010101110111110111011111010101
101000101000101000101010001010100010000010001010101
101011101011101110101011111010101011111110101010101
101000001000101000100010000010001010100000100010101
101011111111101011111110111111111010101111101110111
101000000000001000100010000000100010001000100010001
101111101111111111101010111010101110111010111111101
101000001000000000001000100010100010100010100010001
101111111011111111111111101111111010101110101010101
101000000010001000100000101000000010101000101000101
101011111110101010101110101011111111101011101111101
100000000000100010001000100000000000001000001000001
111111111111111111111111111111111111111111111111111

L
