111111111111111111111111111111111111111311111111111
100010000000000000000000000010000010000000001000001
111010111111101111111111101011111010101111101011111
100010100000101000100000101000001000101000101010001
101111101110111010101110101111101011101010101010101
101000001000001010001010001000101000101010101000101
101110111111101011111011111110101110101110101111101
100010000010101000001000000000101000100010001000001
111011111010101011101110111111101111101011101011111
101000000010101000100010000000000000101000101000001
101111111110101111111010111111111110101110101111101
100010000000100000001010001000001010101010100000001
101011111110111111101011111011101010101010111111101
101000000000000010001000000000101000100010100000101
101111111111111010111011111111101011111010101110101
100000100010000010100000100010001000001010101010001
101110101011111110111111101010101111101110101011111
101000101000000010001000001010101000100000100010001
101011101111111011101011111010111010111111111010111
101000100010001000100010001010001010000010001010001
111110111010111011111110101011101011111010101011101
100000100010001000000000101000100000100010101010001
101111101110101110111111101110111111101110101010101
100000100010100010000000101000100000101000101010101
101110111010111011111110101011101110101011101010111
100010001010100010000010101010000010001000101010001
111011101011101010111010101010111011111110111010101
100010100010001010001010101010001010000000100010101
101110111110111011111010101011101011101111101111101
100000101000100000100010101010001000100000101000001
111110101010111110101110101011111110101110101110101
100000100010001000001000101000000010100010001000101
101111101111101011111011111111111010111011111011101
101000001000001010001010000000001000100010000010101
101111111011111010101010111110101111101110111110101
101000100010000010100010100010100010101000101000101
101010101111101110111010101010111010101110101010101
101010100000101000100010101010100000101000100010001
101010111010111011101110111010101111101011111111111
101010001010001010001000100010101000001000100000001
101011101111101011111011101110101011111010101111101
101000101000001000000010000010101010000010101000001
101010101011101111111110111010111011111110101011101
101010101000100010000010100010001000000010101010101
101110101110111010101110101011101111111010101010101
100010101000100010100000101010100000001010001010101
111010101011101111101111101010111110111010111010101
101000101000100000101000001010100000100010001010001
101111101110111110111011111010101111101111111010111
100000000000100000000010000000100000040000000010001
111111111511111111111111111111111111111111111111111

L
