111111111111111111111111111111111111111111111111111
100010000000100000000000100000000000000010000000101
111011101011101110111110101111101111111011101110101
101000101000000010000010101000101000000000001010001
101110111111111110111011101010101111111111111011101
100000100000000010001000001010001000000000100000101
101111101111111010111111111011111011111110101110101
101000100000100010100000000010000010000010100010001
101110101110101110101111111110111111101010111111101
101000101010101010101000100000100000101010000000101
101011101010101010101010101111101110111011111110101
101000000010101000100010001010001000000000100000101
101111101110101110111111111010101111111110101111101
100000101000100010100000100000100000001010101000101
111110101011111010111010111111111111101010101110101
100010101010001010000010000000001000001000100010005
101110111010101011101111111111101011111011111011111
100000100010100010001000001010001000100000001010001
101111101110111111111011101010111110101111111010101
100010001000100000100010001010100000100010001000101
111011101011101110101110111010101011101110101111101
101000001010001010001000100000101010001000100000101
101111111010111011111011101111111011111011111110101
100000001000101000100010101000000010000010000000101
101111101111101010101110101011111010111011111011101
101000101000100010101000100010100010100010001010001
101010101010101110101011111110101110111110101011101
101010001010001000101000100000101010000000101010001
101011111011111011101110101011101011111111101010101
101010000010001010001000101000000000000010001000101
111010111110101010111011101111111111111010111011111
100010100000101010100000001000001010000010100010001
101010101011111010111011111011101010111110111110101
301010101010000010001010000010101000100000100000101
101110101010111111101010111110101011101111101111101
101000101010000000001010100000001000100000001000001
101011101011111111111010111110111111111111111011101
101000001010000000100010100010000010000000000010001
101111111010111110101110101011111010111110111111111
100010001000100010100010001010001010000010100000001
101010101111101010111011111010111011111011101111101
101000100010001010100000100010001000001010001000041
101111111110101110101111101110101111101010111011101
101000000000101000100010001000100000101000101010101
101011111111101011111010111111101110101011101010101
100010000000100010000010100000101010101000001010001
101111111110111111111010101010101010101011111010111
100000000000000000001010101010001000101010000010001
111111111111111111101110101011111111101110111111101
100000000000000000000000101000000000000000100000001
111111111111111111111111111111111111111111111111111

U
