111111151111111111111111111111111111111111111111111
101000000000100000100000000000100000000000001000001
101011111011101110101111101110101111101110111011101
101010001000001010001000001010101000100010100010001
101110101110111011111011111010101010111011101110101
101000100010001010001000100000101010001000100010101
101011111011101010101010101111101011101110111010111
100010001000100010101010101000001000100000100010001
111110101110111010101110101011111110111111101111101
100000100010100010100000101000001010000000101010001
101110111110101110111111111111101011111110101010101
100010000000100010000000000010001000001000100010101
111011111111111011111111101110111110111011101110101
100010000000000010000000100010100010100010001400101
101111111011111111101010111010101010101010111011101
100000001000100000101010101010001010101010100010001
111111101110111010111010101011111010101110101111101
100000001010000010100010101000001010100010100000101
101111111011111110101110101110111010111010111110111
101000001000000010001000100010001010100010001010001
101111101011101111111011101011101010101111101011101
100000100000100000000010001010001000100000000000101
111110111111111111111010111010111110111111111111101
100010000000000000001000100010000010000000001000101
101011111111111111101111101111101011101111101010101
101000000010000000101000001000101010001000101010101
111110111011101110101111111010101010111010111010101
100010101000001000100000000010101010100010001010001
101010101111111011111111111110111010101111101011101
101010101000000000000000000010100010101000100010001
101010101011111111111111111110101110101010111110111
101000100010000010000000000000100000100010101000101
101111101110101110111111111111101111111110101011101
100000100000101000100000000000101000100000101000001
101110111111101011101111111110101010101111101111101
100010100000101000101000000010101010100010100000101
111110111010101110101111101010101010111010101011101
100010001010001010100000001010000010101010001000101
101010101110111010111111101111111110101011111110101
101010100010001010100000101000000010001000100000101
101011101011101010101110111011111011101110101111101
101000101010000010101010000010001010001010100000001
101110111011111010101011111110111010111010101111111
101000000010001010001000001000100010001010100000001
101111111010101111111010111010101111101010111111101
100000101010100000000010100010001000000010100010001
101110101010111111111011101111111111111110101110111
101000100010100000100010001000000010000010100010001
101011111110111110101110111110111010111010101011101
101000000000000000100000000000100000100000101000001
131111111111111111111111111111111111111111111111111

R
