111111151111111111111111111111111111111111111111111
101010000000001000000000001000000010000010000010001
101010111110101011111110111010111110101010101110101
101010001000101000100010100010000000101010100000101
101011101011101110111010101111111011101011101111101
101000001010101000100010001010001000101000100000101
101111111010101011101111111010101111101110111011101
101000000010101000100000000010100000001014001010001
101011111110101110111110111010111111111011101010111
101010000000100010100010100010000010000010001010001
101010101111111010101010101111111011101110111111101
100010100000001010001000100010001000101000100000001
111110111111101011111111111010101110101011101111111
100000001000101010000010000000101000101000100000001
101111101011101010111011111111111011101110111011101
101000100010001000101000001000001010000010001010001
111010101110101111101111101011101011111011101110101
100010101000100010100000100010100010000000101000101
101110111011111010101010111110111110111110101011101
100010000010000010001010100000001000100000100010001
101011111110111111101011101011101011101111111110111
101010000010100000101000001010001000100000100000101
101011101010111010111111111010111110111110101111101
101000101010100010000000001010000000100000101000001
111110101110101111111111101011111011111111101011101
100000101000101000001000101010001010000000001010001
101111101011101011101010101011101010111111111010111
101010001000001000100010001000100010000010000010001
101010101111111110111111111010111011111011111011111
101000100000100000100000101010001010001010000010001
101111111010101111111010101011101011101010111110101
100000001010001000000010001010001000001010000000101
101111101011111110101111111010111110111010111111101
101000001010000010101000000010100010100010000000101
111011111011101011101011111110101010101111101111101
100010100010001000100000000010101010100010001000001
101110101110111110101111111010101010111011101011101
101000100000100010101000100010101010001000101010101
101010111011111010111010111110101011101110111010101
101010000010001010000010001000101010000010100010001
101011111110101011111111101011101010111110101111111
101000001000101000000000000010001010001000101000001
101111101011101011111111111110111110111011101011101
100010101000101010001000100010100000100010001000101
101010101110101011101010101010101111101110111011101
101010000010101000101010001010001000101000000010001
101011111010101110101011111010111011101011111010101
101000100010101000001010001010000010001010001010101
101110111110101111111010101011111110111110101110101
100010000000100000000000101000000000000000100000101
111111111111111111111111111111111111111311111111111

U
