111111111111111111111111111111111111111115111111111
101000100000000000001000000000100010000000000000001
101010101111111011111011111010101010111111111111101
101010001000001010000010100010101010001000001000101
101111111011101010111110101110101111101011101010101
101000000010001000000010100010001000001000100010101
101011111110111111111010111011111011111010111110101
101000000010001000100000001000001000100010001010101
101111111011101010111111101111101110111111101010101
100010001000100010100010101000100010001000101000101
111010101110111110101010101010101111101010101011101
101000100010100000101010101010100000101010001010101
101111111010111011101010101010111010101011111010101
100010000010001000001010101010000010100010000010101
101010111111101111111010101011111111111110111110101
101010001000001000000010001000001000000010000000101
101011101011111011111110111111101011111011111011101
101000100010100010100000100000101000001000000010001
111110111110101110101111101111101111101111111110101
100000001000100010101000001000000010001000100000101
101111111010111010101110111011111010111110101111111
100000001010000010001000100010001010001000100000001
101111101011111111101011101110101011101011111011101
100000101010000000100010001000100010000010001000101
111110101010111110111010111110111110111110101111101
100010101000100010100010100010100000100000100010001
101011101111111010111010101011101111101111111010101
101000001000000010001010001000100010100040101010101
101110111010111111101110111110111010111110101010111
100010100010000000100010101000001000000010100010001
111011101111111110111010101011111111111010101111101
100010001000001000001010001010000000000010100000001
101010111011111011101011111010111111111110111111101
101010100000100010101000001010001000000010001000001
101110111110101110101111101011101010111011101011111
100000100000100010001000001000001010100010101010001
101111101110111011101011111011111010101110101011101
101000001000101000101000001000101010100000101000001
101111101011101110101111101110101010111110101111101
100000001010001000100000100010100010000010101000001
111111111010111011111111111010111111111011101111111
100010000010001000000000100010000000100010001000001
101110111110101111111110101111111110101010111011101
100000101000100000000010001000001000001010000000101
101111101011111011111011111010101111101111111111101
101000100000001010001010001010100010001000000000001
101010101111111011101010101010111010111011111111101
101010000010001000101010100010001010100010000010001
101111111110101110101011111111101011101110111110111
100000000000100000100000000000001000001000000000001
111311111111111111111111111111111111111111111111111

L
