111111111111111111111111111111111111111111111111111
101000001000000000000010000010000000000010000000001
101011101111111011111011111010101111111010111110111
100010001000000010001000001000100010000010000010001
111110111011111110101111101111111011111111101111101
100010100010001000100000001000001010000000101000101
101110101110101011111111111011101010111110101010101
101000100010101010000000000010001000001010001010001
101011101010101011101011111110111111101011111011101
100010001000101000101000100010000010000000100010001
101111111011101110101110101111111010111110101111101
100000001010001000101000101000100410100010100000101
111111101110111011111011101010101110101010111110101
500000100000101000100010000010001000101010001010101
101110111111101110101110111111111111101011101010101
100010100010001000101000000010000000001010000010101
111010101010101011101111111011101111111011111010101
100010001000101000100000001000001000001000100010101
101111111111101110101111101111111110111110101110101
100000100010000010100010101000000010000000100010101
101110101110111110111010101011111011111011111110101
100010101000001000101000100010001000001010001000101
111010101011111011101110111110101111101010101011101
100010101010100010000010100010100000001000100010003
111110101010101110111010111010111111111111111110111
100000101000100010001010000010100000100000000010001
101111101110111011111010111110101110101011111011101
101000100010100010001000100000100010101010000010001
101011101010101110101011101111111010111011101110111
101010001000100000101000100000000010001000100010101
101010111111111111101111111110111111101110111010101
101000001000100000100000000010001000100010001010001
101111101010101110111111111010111010111010101011101
100000100010100010000010001010100010000010101010001
101110111110111011111011101010101111111110101110111
100010000010000010000000001010101000000010100000101
111011111011111111111110111010101011111010111111101
101010001010000010000010100010101010000010100000101
101010101010111010111011101111101010111110101110101
100010101000100010101000001000001010001000100010001
101111101111101110101111111110111011101011111011111
100000000000100000101000000000100010001000001000001
111111111110111111101011111011101110101111101111101
100000001000100010001010100010000010101000100000101
101011101011111010101010101111111110101011111110101
101000101010000010100000101000000000100010000010001
101110111010111110111111101010111110111110101111101
101000100010000000100000001010001000100000101000101
101011101111111111101111111011101111101111101010101
101000000000000000001000000000100000000000100010001
111111111111111111111111111111111111111111111111111

U
