111111111111111111111111111111111511111111111111111
100000100000000010001000000000100000000010000000001
111110101111111011101011101110101111101010111110111
100010101000001000100000101010100010001010100010001
101010101011101110111110101010111110111010111011101
101010001000100000100010101010000010001010000010001
111011111110111111101011101011111011101011111110111
100010100010101000001010001000001010001000000010001
101010101010101010111010111011101010111111111011101
101010101000100010001010100010001000101000000010001
101010101111111110101010101110111111101011111110101
101000101000000010101000101000100000001000000010101
101110101011111010101111101011101110111111111010101
101000100010100010101000001010000010100000001000101
101111111110101111101011101011111110101110101111101
101000000000001000001010001000100010101000101000101
101011111111111011111010111110101010101011101110101
100010000000001010000010100000001010101010001000101
101111101011101011101110111111111010101011101011101
100000101010001000100010000000100000101000100010001
111110101011101110111110111110111011101110111110111
100010101000100010000010100010001010001000100000101
101010111110111011111010101011101010111011101111101
101010100010101010000010001010101010001000101000001
101010101010101010111111111010101011101110101010111
101010001010101000100000001010101014001010101010001
101011111010101111111110111010101110111010101011101
101000001000100010000010001010100000100010001000101
101111101111101010101011101010111111101011111111101
101010001000101000101000001000100000101000100000001
101010111010101111101111111110111010111010111011111
101000101010101000001000100010000010001010001000001
101110101010101011101010101011111111101011101111101
100010001010001000101010001000001000101000100000101
101010111011111110101011111011101011101110111110101
101010100010000010101010001010001000100010100010101
111010101110111010111010101011101110111010101010101
100010100010101010000010101000100010001000101010001
101111111010101011111111101110111011101111101111101
100000000010101010000010001000100000001000100000001
101111111110101010101010111010111111111010101111111
101000000010101010101000100010100000100010101000001
101110111010101010101011101111101110101110101110101
100010001010001000101010001000001010101010001000101
111011101011111111101010111011111010101011111011101
101000001000000000001010000010000010101000000010101
101111111111111111111011111110111010101110111110101
100010001000001000001010000010100010001000100000101
101010101010111011101010111010101111111011101111101
101000100010000000100000100000100000000010000000001
111111111111111111111111131111111111111111111111111

R
