111111111111111111111111111111111111111111111111111
300010000000000000000010000000001000001000000000001
111011101111101111111011101011101010111011111111101
101000100010001000001000101010001010100000001000001
101110101110111011101110101011101011101111111011111
100010101000101010001000101000100010000010001000001
101010101011101010111011111110111110111110101011101
101010101010000010001010000010000000100010101010005
101110111010111111101010101011111111101010101010111
101000100010000000100010101000000000101000101010001
101011101111111111101110101111111110101111101011101
101010000000100000101000100010000010101000001000101
101011111010101110101110111010111010101011111011101
101000001010100010100010001000100010001000100010001
101111101010111010111011101111101111111110111110101
100000101010000010101010101000001000001000100000101
111110101111111010101010101011111011101110101111101
100000101000001010100010001000001010100410100010001
101110101011101010101111111111101010111010101011101
101000100010101010101000000010001000101010101000101
101011111110101110101011111010111110101010111110101
101010001000101000101000101010100000101010000010101
101010101010101011101110101010101111101011111010101
101000101010100010100000100010101000101000001000101
101111101011111110111111101110101010101111101111101
101000001010000000000010100010101010001000101000001
101011111010111111101010111010101010111010101011111
101000100010000000101010100010000010100010001010001
101110101011101111101010101110111111101111111011101
100010001000101000101000101000100000001000001000001
101011111110101010101110101111101111111110101111101
101000000010101010001010100000100010000010100000001
101111111011101011111010111110101010111011111111101
101010000010001010001000100000101000101000000000101
101010111010111011101011101111111110101111111110111
100010100010001000100010101000000010000000100010001
111010111111101110101110101011111011111111101010101
100010000000101010101000100010001000000000101010101
101111111110101010101011111111101111111110101011101
100000101000101010101000000000000010000010101000001
111110101010101010101110101111111010111110101111101
100010101010100010100000101000101010100010100010101
101110101011111010111110111010101010101010111010101
100000101010000010100010100010100000101010001010001
101111101010111110101011101110101111101011101010111
100000001010000010101010000010101000001000100010001
111011111010111110101010111110111011111011111111101
101010000010100000101000101000100010100010000010001
101010111110101111101111101011101110101110101110111
100010000000100000000000001000000000100000100000001
111111111111111111111111111111111111111111111111111

L
