111111111111111111111111111111111111111111111111111
101000000000000000100000000010001000000000000010001
101011101111111110111011111010101011111111101011101
101000100000001010000010001000101010000000101000001
101111101111101011111110101111101110111110101111101
100000101000001000000000100000100000100010001000001
111110111011111011111110111111111111101111111011111
100010001000001000001010000000000010000000001010001
101011101111101111101011111111111010111110111011101
101000001000001000101000000000001010001000100010001
101111111011111011101010111111101011101011101110101
101000000010100010001010001000101010001000100000101
101110111010101010111111101010111010111110111111101
100010100010101000100000100010001010100010000000101
111011101110101111111010111111101010101011111010101
101010001010001010000010000000101000101010000010101
101010111010111010101111111110101111101010111111101
101000100010001010101000100000001000001010000000101
101111101011101010101010101111111010111011111110101
101000001010101010100010100000100010101000100010001
101010111010101010111110111110101110101110101011111
100010101010101010100010000010100010100010101000001
111110101010101010101111111010111010111010111011101
100000100000101000001000100010001010001000100010001
101111111011101011111010101111111011101110101111111
100000001010001000100010100000001000100010100000001
101111101110111111101110111011101110111010111111101
100000100010000000001010001000100010101010000000101
111110111011111111111011101110101010101010111110101
100000001000001000000010001010101010001010100010101
101111111111101011101010111010101011101011101010101
100000100000100000101010100000101010001000001010001
111111101110101111101010111111101110111111111011101
100000001010101000001010000000100000000010001010001
101111111010101011111011111110111111101110101010111
100010000010101000001010000010001000101000101010101
111010111110101111101011101111101010111011101010101
100010100000100010001000001000001010100010100010101
101110101111111110111111101011111010101110111110101
101010000000000010001000001000100010100010000010001
101010111111111010101110111110101110111010101111101
501000100000001010100010101000141000100010101000001
101111101111101011111010101011101110101110101011111
101000001000001000100010001000100010001000101000101
101011111011111110101011111110101011111110101110101
101000001010000000001010000010101000001000100010003
101111101011111111111110111010111111101011111111101
100010001010000000000010001000100000101000001000001
101010111010111111111011101111101110101011101011111
101000001000000000001000000000001000001000100000001
111111111111111111111111111111111111111111111111111

D
