111113111111111111111111111111111111111111111111111
101000000000100000001000000010000000000000000000001
101111101110101011101110101110111111101111111111101
100000100010101010100010100000001000001000000000001
111110111010111010111010111111111010111110111111101
100010001010000010001010000000100010100010001000101
101111101011111110111011111110101110101011101010111
101000001010000000000010100010100010101010001010001
101011111011111110111110101010111010101010111011101
100010000000000010100000101000001010101010001000101
101110111111111010111110101111111011101011101110101
101010100000001010000010101000100010001010001000101
101010101110111011111010101011101010111010111011101
101000001000100010001010100010001010001010001000101
101110111111101110111010111010111110111011111011101
100010100000001010000010001010000000100010000010001
111010101111111010111111101011111111101110111110111
100010101000000010100000101000000000101000100010001
101111101011111010111010101011111110101011111011101
100000001000001000100010101010001000101010000010101
111111111111101111101110101010101111101011101010101
100000000010001000001010100010100000100010001000101
101110111110111110111010111110111110101110111110101
100010100010000000100010100010001010100010100010101
101010101011111111101010101011101010111010101011101
101010101000000000101010001000101014100000101000101
101011101110111110111011111110101010111111101110101
101000001010100010000000000010101000100000001000101
101111111010101011111111111010101011101111111011101
101000000010101000100000100010001000100000100000101
101011111110101110101110101111111110111010111110101
100010000000101010101010100000100010001010000010001
111110111111101010101010111110111011101011111011101
100000100000001000101010000010000000101000001000101
101111101011111011101011111011111110101111101110101
101000001000001000100000001000000000101010001000101
101110111110101011111011111111111110101010111011101
100010100010101010001010000010000010101000101000101
101011101011101110101010111010111011101011101110101
101000101000101000100010001000101000001000001000101
101110101110101011111111101111101111111011111011101
101000100010001000100000101000000000001010000010001
101011111011111110111110101011111010111010111111101
101000001000000010100000101010001010000010100000101
101111101111101110101110101110101111111110101110101
101000100000100000001000100010100000000010000010101
101110111110111111111111111010111111111011111110101
101000100010001000100000001000100000000010000000101
101010101011101010101111101111101111111110111111101
100010001000100010000000100000000000000000100000001
111111111111111111111111111111111111111111111115111

D
