111111111111111111111111111111111511111111111111111
100000100000100000100000001000000010000000100000001
111110101110101010101011101010111110111010111110101
100010100010101010101010001010001000001010000010101
101110101011101011101011111011101011111011111010101
100010101000001000001000000010100010100010001010101
111010111111111011111111111110111110101110101011101
100010100000001010000000001000000000101000100010001
101010101111101011101111101011111010101111111010101
101010101010001000001000001000001010101000001000101
101010101010111111111011111111111011101011101111101
101010001010100010001000100000000010001000100010001
101111111010101010101110101111101110101110111011101
100000000000101000100010101000001000100010101000101
101111111111101111101010101111111011111110101110101
101000100010001000001010100010000010000000101000101
101010101010111011111110111010111010111111101011111
100010001010001000001000100010100010001000001000001
111111111011101111101011101110101111101011111111101
100000100010000000100000001000101000001000000000101
101110101111111111111111101011111011111111101110101
100010100000001000000000101000001000100000001010101
111010111111101011111110111110101110111011111010101
100010000000101010000010000010100010100010100010101
101111111010101010111011111011111010101110101010101
101000001010100010101010001010000010001000101000101
101011101010111110101010101010111111111010101111101
101000100010000010001000100010000000000010100010001
101110111111111011101111111110111110111110111010111
100010100000001000100000000010000010100000100010001
111010101111101011111111111011111010111111101111101
100010101000101010000000001010001010000010001000001
101110101010101110111110111010101011111010111011101
100010001010100010000010100010101010100010100010001
111111101011111011111010101110101010101110101111111
100000100010000010000010100010101010100000100000001
101110111110111010111110111010101010111111111111101
101010000010101010000010001010100000001000100000001
101011111010101011111011101011111111111010101111101
101000000000100000001010001000100000001010101000101
101011111111101111111010111110101111101010101010101
101010001000001000100010000000100000100010101010101
101110101111111010101111111111111110111110101010111
100000100000000010101000000000000010000010100010001
101111111111111010101110111111111010111010101111101
101000001000001010100000100000100010001010100010401
101110101011101110111111101011101111111010111110111
101000101010000000100010001000001000100010000010001
101011101011111111101010111111111010101111111011101
100010001000000000001000000000000010001000000000001
111111111111111111111111111111111111111111111311111

R
