111111111111111111111111111511111111111111111111111
101000100000001000001000000000000000000010000000001
101010101111101110101111111111111110111010111011101
100010001000001000100010000000000010001010001010001
111111111011111011111010111111111010101011101011111
100000100010000010000010001000001010101000101000001
101110101111101011111011101111101011101111101111101
100010001000101010001000100010001010001000001000101
111011111010111010101110111010111010111011111010101
101000100010001010101000000010000010100010000010101
101110111011101010101111111110111110101110111110101
100000100010000010100000100010000000101010100000001
101111101110111110111110101011111011101010111111101
100010000010101000100010101000100010001010000010101
111010111010101011101110101011101110111011111010101
101010001010001000001000101000101010000010100010001
101011101011101011111011111110101011111010101011111
101010001000101010000010000000101000001010101010001
101011101110101010111110101111101110111010101110101
101000100010101010000010100000100000100000100000101
101110111010111011111011111110111011101111111111101
101000101010000000100010000000101010001000000010001
101011101011111110101110111110101010111011111010101
101010000010000010101000100000001010001010001000101
101010111110111011101010111111111011101010101111101
101010001000100000101010100000000010001000100000101
101011111011111110101110101111111110111111101110111
101000001000000010100010001000100000100000100010001
101111101011111010111010111010101111101110111111101
100000101000100010001010000010101010001010100000001
111110101110101111101011111111101010111010101111101
100010101000101000101010001000101010100010101000001
101010101011101011101010101010101010101110101111101
101000101000101000001000100010000010100010100000101
101111101111101011111111111111101110101010101110111
100000001000101000100010000000101000101010100010001
101111111010101110101010111110101011111010111111101
101000000010001000101010100010101000100010001000101
101011111111111011101010101110111110101011101010101
100010001000000010001010100010100000101010001010101
111111101011111110111010101010101111101110111010101
100000001010000010100010101010001000001000100010001
101111101010111010101110101011111110111411101111101
101000001010001000101000101000000010100010001000001
101011111011101111101010111010111010101110111111101
101010001010001010001010001010001000101000000000101
101110101010111010111111101011101111101111111110111
100010100010001010100000101000100000100010000010001
101010111111101010101110101110111110111010111011101
101000000000001000001000001000000010000000100000001
111111111111111311111111111111111111111111111111111

D
