111111111111111111111111111111111111111111111111111
101000000000100000100000000000000010000000000000001
101111111010111011101111101111111010101111111111101
100000100010001000001000001000000010101000100000001
111110101111101011111011111111111110101011101111111
100000101000001000001000000000000000101010001000001
101111101011111111111011111111111111101010111011101
101000001000000010001010001000000000001010001000101
101110111111111010101110101011111111111011101111101
101000101000000010101000100010000000100000101000001
101011101011111110101011111111111010111010101011101
100010001000100000101010001000001010001010100010101
111110111110111011101010101010101011101010111110101
100400000010001010100010101010100010100010100010001
101111101011101010111110101110111110111110101010111
301010001000100010000000100000100000000000001010101
101010111111111111111110111111101111111111111110101
101010000000000000001000101000101000001000100000101
101011111111101111101011101010101110101010101111101
100010000000101010000010000010000000100010101000001
111010111110101010111110111111111111111111101011111
101010000010001010100010000010001000000000001000001
101011111011111010101011111110101011111111111111101
100010001000001000101000000010101010000000100000101
101110101111101011101111111010101011101010101010101
101000100010001000100000001000101000101010101010001
101011111010101111111111101111101110111011101011101
101010100000101000000000100000100010001010001000101
111010101111111011101111111011111011101010111110111
100010101010001000100000000010001000101000000010001
101110101010101110111111111110101011101111101111101
101000000010100010100000001000101000101000101000001
101111111010101110101011101011101110101010111011101
100000100010100010101000101000100000100010000010101
101110111010111010111010101110111110111111111110101
100010001010101010001010100010100010000010000000001
101111101010101011101110111110101110111110111111111
101000101010101000001000100000100000100000100000001
101010101110101111111011101111111111101111111110101
101010101000100000000010001000100000001000000000105
111010101011111011101010101010101111111010111111101
100010001000001000101010101010101000001010001000001
101011111111101110101110111010101010101111101011111
101010000010001000100010001010001010100000001010001
101110111010111111111011101011111110111111111010101
101000101000100000000010001010000000100000001010101
101011101111101111101110111011111011101110111010111
101010001000100010001000100010000010101010100010001
101010101010111010111011101110111110101010101111101
100000100010000010001000000000100000000010000000001
111111111111111111111111111111111111111111111111111

R
