111111111111131111111111111111111111111111111111111
100000100000000000100000001000000000100000000000101
111110111011111110111110101010111110111110111110101
100010100010000000000010100010000010000000100000101
101010101111111111111010111111111011111111101111101
101010100000100010001010100000001000101000101000001
101110111110101010101011101111101110101010101011101
100010000010001010101010001000100000100010101000101
101011111011111010101010111110111111101110101110101
101000001010000010100010001000001000101010101000101
101011111010111114111111101011101010101010101011111
101010000010100000100000001010001010100010001000001
101010111110111011111011111010111110111011111111101
101010100010001000001000100010000000101010000000001
101010111010101111101110101011111110101010111111101
101010100010100000100010101000000010001000100010001
101010101010111110111010101111111011111111101010111
101010101010001010101000101000001000001000001010001
101010101111101010101111111011101111101011101111101
101010100010001010100000000010101000001010100000001
111010111010111010101110111110101011111010111111111
100010001010001010101000100000101000001000100000001
101011101011101010111011111110101111101110111111101
101000101000100010100010000010100000100010000010001
101111101010101110101111101010111110111011111010101
100010001010001000100010001000000010000010001010101
101010111011111011101010111110111111111011101010111
101000101000100010001010001000100000000000001010001
101111101011101110111010101111101111111111111011101
101000001010001000100010101000001000001000001000101
101111101010111111101111101011111011101011101110101
100000100010100000001000001010001010101000100010001
111110111110111011111011111010101010101110101111101
100010000010001010001000000000101010100000100000101
101111111011101010101111101111111010111111111110101
100000101000101000100000100010001010100000000010001
101010101110101011111110111110101010101111111011111
101010000010001000001000100000101010001000000010001
101011101111111111111011101111101011111011111010101
101010001000000000000010001000001000000010100010101
101011101010111110111110111011101111111110101110101
101000101010000010100010101000100010000000101000101
101110111011111011101010101110111011101011101011101
101010100000100010001000100010101000001010001000101
101010101111101110111111111010101011111110111110111
101010001010001000100010000010100010001000100010001
101011111010101011101011101110101110101011101011101
101000100010101010001000001000100010100010001010001
101010111010111010111111101011111110111111101010101
100010000010000000100000001000000000000000001000101
111115111111111111111111111111111111111111111111111

D
