111111111111111111111111111111111111111111111111111
101000000000001000000000100000000010000000000000101
101110101111101111101111101110111110101111111110101
100010101000100000101000001000100000101000000000101
111011101010111110101011111011101111101111101111101
101010001010001000100010001000001000100000100000001
101010111010101011111010101111111010111110111111111
101010100010101000001010101000000010100010000000001
101010101110101111101010101011101110111011111111101
100010100010100010001000101010100010001000000000101
101110111010111110111111101010111011101011111111101
100000100010000000100000101000001000101000000010001
111111101111111111111110101111111110101111111010111
100000100010100000000000101000100000100000000010001
101111111010101111101111101010101011111110111111101
101000001010001010001000100010001010001000100010001
101011101010111010111010111111111010101111101010111
101010100010000010000010001000001010100000001010001
101010111111101111101111101011101010111111111011101
100010000000001000101000100000100010100010000000001
101110111110111010111010111111111110101010111111101
100010100010100010100010100000001000101010100000101
111011101011101110101110101111101011101010101110101
101000101000001010001010001000101010101000101010101
101110101111111011111011111010101010101111101010111
100010001000001000000010000010001010000010001010001
101011111010111010111010111111111011111110111011101
301000001010100010001010000000100010000000100000101
101111111010101111101011111110111010111111111011101
100000000010100010101000000010001000000000001010005
111111111110111010101111111111101111111111101010101
100000001000100010100000000000001000001000101010101
101111101010101110111111111111111011101110101010111
100000100010100010000010000000100010100010000010001
111110111011111010111011101110111010111010111110101
100010101010000010101010001010000010001010100010101
101010101010111110101010111011111111101010101010101
101040100010100000100000100000000010001010101010101
101110111110111011111111111111101010101011101011101
101000100010100010001010000000001000101000001000001
101111101010101110101010101111111111101111111111101
100000001010100000101000101000001000101000001000101
101111111010101111101111101011101010101110101011101
100000001010100010001000001000101010000000100010001
111111101010111110111010111110101111111111111010111
100000001010000000100010100010100000100000100010101
101111111011111111101011101010111110101110111110101
100000100010000010001010001000100010100010000010001
111110101110111010101110111111101010111011111011101
100000100000001000100000000000001010000000001000001
111111111111111111111111111111111111111111111111111

L
