111111111111111111111115111111111111111111111111111
101000000000100000000000100010000000000000101000001
101110111010111110111010101011111110111110101010111
100010100010000010100010001000000010100000100010001
111011101111111011101111111111111010111110111111101
101010001000001000001000000010001010000010000010001
101010111011111111111011111011101011111011111010111
101000100000000010001000001000101000001000101010001
101111111011111010101011101110101111101110101011101
100000001000001000100010101010100000100000101000001
101111101111101111111110101010101110111111101111101
100010001000000000100000101000101000001000100000101
101010111111111110101111101011111011101010101110101
101010000000100010001000101000001000101010101010101
111011111110111011101010101111101110101010101010101
100010001010001000101010101000001000101010001010101
101110101011101010101010101011111011101011111010101
101000101000001010001010001000000010001000100010001
101011101011111110111011111111111110111110111011111
101010101000000010101010000000100000100010001000001
101010101111111010101010111110111011101011101110101
101000101000000010001010000010001010001000100000101
101011101011111111101011101111101110111110111111101
101010001010000000101000101000001000100010001000001
101010111010111110101011101011101011101110101011111
100010101010000010001000001000101000100010101000001
101110101011111111111011111110101110111010111111101
101010100010000000001010000000100010000010100000101
101010111010111111101110111111111011111010101011101
100010001000100000100010100000000000100010101000101
111011101111101011111010111111111111101110101110101
101000100000101010000010000000100000100010100010001
101110111110111010111111111110101114111010111011111
100010101000100010001000000000101010000010000010001
101010101011101111101010101111101011111111111110101
101010101010100000101010101000100000000000001000101
101010101010101110101010111010111111111111101010101
101010101010001010001010000010000010000010001010101
101110101011101011111111101111111010111010111110101
101000101000101000000000100000100010101010000000101
101011101110101011101110111011101110101011111111101
100010001000101010001000101010001000101000000000101
101111101011101110111011101010111011101011111111101
100000001010000000101010100010100000001010001000001
111111111011111111101010101110101111111010101011111
100000000010001000000010000010101010000010100010001
101111111010101110111111111110101010111010111110101
101000100010100010000000000000100010100010100000101
101010111110111011111111111111111010111110111011101
100010000000001000000000000000000010000000000010001
111111111111111111111111111111111311111111111111111

D
