111111111115111111111111111111111111111111111111111
100000000010001000000000000010100000000000000010001
111111111010101011111011111010101111111110111011101
100000100010101000100010001010001000000000101000101
111110101110111110101110111010111011111111101110101
100000101010000000101000100010101010000000000000101
101111101010111111101011101110101011111011111111101
100000001000001000101010001000001010001000100000001
101111111110111010101010111111111010101110101111101
101000000010100010001010100000001000101000101000001
101110111011101111111010101011101111101011101011111
101000101000101000000010101010000000101010001000101
101011101110101111101110101011111110101010101110101
101000100000101000001000101000001000001010100010001
101010111011101011101011111110101111111010111011111
101010001000001010001000000010100010000010001000001
101011101111111010111111111010111011101111111111101
101000101000000010100010000010101000100010000010001
101111101110111110101010111110101110111010111010101
100000100010000010101000100010001000101010100010101
111110111010111010101111101110111011101010101110101
100010000010101010101000100000100010001010101000101
111011111110101010101110101111101110101010101010111
100000100000101010100010001000100010100010101010001
101111101111101011111010111010111011101110101111101
101000001000001000000010000010101000141000100010001
101011111011101111111111111110101110101011111010101
100010000000100000000000001010100010100010001000101
101111111010111111111111101010101110111110101111101
101000001010100000000010001010001000100000101000101
101011101110111110111110111011101011101111101010101
101010100000100000100000100000101010001000101010101
101010111111101111101111111110101010101010101110101
100010000000000000001000000000101010100010100000101
111110111111111111111010111111101010111110111111101
100010100000100000100010100010001010000010100000001
101110101110111011101011101010111011111010101111111
100010001010001010001000001000001000100010100010001
111011111011101010111111111111111110111110111010101
100000100000001000000010000000000010001000100010101
101111101111111011111110111111111011101010101110101
100000001000000010000000100000001000001010100000101
101111111111111110111111101111101111111011111111101
101000000000100000100000101000100000101000000000001
101111101110101111101110101010101110101011111111111
101000100010001000101010101010100010001010100000001
101010111011111110101010101011111011111010101110101
100010000010000000100010001010000010000010000010101
111111111110101111111011111010111110111111111110101
100000000000100000000000000010000000000000000000101
111111111111111111111111111111111111111311111111111

U
