111111111111111111111111111311111111111111111111111
100000001000001000100000000000100000000010000000001
111111101011101010101111101110101110111010111111101
100000101010001010100010001000100010101000100000101
101111101010111110111010111011111110101111111011101
101000001010000000100010100010000000100000000010001
101011111011111011101110111011101111101111101010111
101010001000001010001010001000001000101000101010101
101010101011101110111011101111111011101011101110101
101010100010100010100000101000001000001000100010001
101011101110111010101110101011101011111110111011101
101000100000001010001000101000100000001000101000001
101110111111101011111011101111111111101010101111111
100010100000101000000010101000100010000010100010001
101110101110111111111010101010101011111110101011101
101000101010000000001000101010001000001010001000001
101011101011111111101110101011111111101011111111101
100010001000100010001000100010000000001000000010001
101110101010101010111111101110111111111011111110111
100010101010101010000000101000100010000010000010001
111011101011101011111110101011101110111010111011101
100010001000001010001000101000100010001000101000001
101110111011111010101011101110111011101111101111111
101000100010001000101010000010001000100000001000101
101110101110101111101010111111101010111111101010101
100000100010100000101010100000001010000000101010001
111111111010111110101010141111111011101110101011101
100000001010100010100010101010001010100010101000101
111011111010101110111111101010101010111010101010111
100010000010100010100000001000100010100010101010001
101110111110101010101110111011111110101111101111101
100010000010101010001010101010000010100000000000101
101011111010111011111010101010111010111111111110101
101000001010000000000010100010001000001000001010101
111110101011111111111110101111101111111011101010101
100000101000001000100010101000001000000010101010001
101111101111101010101010101110111011111110101011101
100010000000101010001010100000100000000000101000101
101011101111101011111010111110101111111111101010101
101000101000001010000010000010100010000000001010001
101110111011111010111110111011111010111111111011111
100010001010000010100000101000000010100000101000001
111011101010111010111110101111111010101110101111101
101000100010100010000010001000001010100010001000101
101110111111101111111011101011101010111010111010101
100010100000001000101000101010001010100010100010101
101110111110111010101110111010111010101111101110101
100010000000100010001000100010001010101000100010101
101011111111101111111011101111101110101010111010101
101000000000000000000000001000000000100010000010001
111111151111111111111111111111111111111111111111111

D
