111111111111111111111111111111111111111111111111111
101000001000100000001000000000100010000010000000101
101110101010101111101110111110101110101010101110101
100010101010001000001000100010100000101010101000101
111010101011111011111011101010111011101011101011101
101000100010001010000010001010001000101000001010001
101111111110111010111010111011101111101111111010101
100010000000000010100010100000100000001000000010101
101010111111111111101111101110111111111011111110101
101000100000000010001000001000100010001000101000101
101111101111111010111010111011101010111110101011101
100010001000100010100010001000001010100000101010001
111010111010101110101111101111111010101111101010101
101000100010101000100010100010000000101000000010101
101111101110101011111010111011111111101011111110101
100000001000101000001000001000000000001010000000101
101111101111101111101111101111111111111010111011111
101000001000100010001000001000000010000010100010001
111011101010111010111011111011111010111110111110101
100010001010001000100010001000001010001010000000101
101011111010111111101111101110111011101011111111101
101010000010000000101000001000100000101000000000101
101110111111101111101011111011101110101110111111101
100000100000100000001000000010001000101000100010001
101111111110111111111011111110111011101011101010101
100000100010000010000000000010100000100010001000101
111110101011111010111111111010101111111010111111101
100010101000100010001000001010100010001010100000001
101110101110101110111011101110101110101010101111111
101000101010100010100010101000101000101010100000001
101011101010101010101110101011111011101010111111101
101000101010101010100010101010000010001010001010001
101110101010111010111010101010111110111011101010111
100010101000001000100010101000000010000010001000001
101110101111101110101110101111111110111110101111101
100000100010000010101000101000000010100000101000105
101111101011111011101010101011111011101111111010111
100010101000100000001010101000101000101000000010001
111010101110111111111011101010101110101011111111101
300010000010001000000000001010100000100010001000001
101111111110101011111111111110101111101110101011111
101000000010101000001000001000100010001000101000001
101011111011101111101011101011111011111011101110101
100010001000001000100010100010001000001000100010101
111110111111111011111110111110111111101110111011101
100000001000000010001000001000000000100010001000101
101111101010111110101010101011101111111010101110101
100000100010000000101010101010101400000010100010001
111110111111111111101010111010101011111111111011101
100000000000000000100010000000100000000000000010001
111111111111111111111111111111111111111111111111111

D
