111111111111111111111111111111131111111111111111111
101000000000100000000000000000000040001000000000101
101111111011101111111011111111111111101011111110101
100000001000000000100010001010000010001000100000101
111111101111111111101110101010101110111010101111101
100010100010000000100010101010100010001010100000001
101010111010111110111010101010111011101110111111101
101000100010100010000010100010101000101000100000101
101011101110101111111110111110101110101011101110101
101010001000100000101000000010000010001000000010101
101110111010111010101011111011111011111111111110101
100010001010001010001000001000001010000010000010101
111011101111101011111111101111101010111010111010111
100010001000001010000000101000001010100010100010001
101010111011111010101111101011111010101110111011101
101010100010000000100000101000001000101010001000001
101110101110111110111110101111101111101010101111101
100000100010100010000010000000100000101000101000001
101111111011101011111111111111101011101011101011111
101000001010001000100010000000101000101000101000101
101011101010111110101010111110111110101111101110101
100010001000100010001000001000100010100010001000101
111110111011111011111111111011101010111010111011101
100010001000000010000000000010001000001000101010001
111011101111101110111111111110111111101111101010101
100000100010101000100000000000101000001000001000101
101110111010101011101011111111101011111011101111101
100010101010001010001000001000001000000010100010101
101010101011101010111111101011111111111110111010101
101010101000101010100000101010000000000010001000101
111010101110111011101110101010111111111010101110101
100010000010000010001010101000100010001010100000101
101111111011111110111010101011101010101010111111101
100010000000001000100000101010001010100010100010001
101011111111111010101111101010111010111110111010111
101000100000000010100000101010001010000000000010001
101110101111111110111110101011111011111111111111101
100010101000000010000010001010000000100010000000001
101110101111101011111011111010111110101010111111111
101000100000001000101000001000100010001010000000001
101011111111111110101111101111101111111011111111101
101010000000100000100010001000100000000010000000101
111010111110101111101010111010101111111110111110101
100010100000100010001010001010100010000010000010101
101010101110111011111011101011111010111011111010101
101010100010001000000010001000000010001000001010101
101110111010111111101110111110111111101110101010101
100000101010100000101000100010001000101000101010101
101111101011101110101011101011111010101011111010101
100000001000000010001000001000000010001000000010001
111111111111151111111111111111111111111111111111111

R
