111111111111111111111111111111111111111111111111111
101000000000100000000000001000001000100000000010001
101110111110101111101011101011101110101111101011101
100010000010101000101010000010100010000010001000001
111011101011101010101011111110111011111110111111101
101000101000001010101000001000100010000010100000101
101110101111111010111110101110101110111010101011101
100010101000000010000010100010001000101000101000001
101010101011111111111011111010111110101111101111111
101010101010000000000010000010100010100000101000001
111010111011111110111110111110101010101011101011101
100010001000100010100000100010001000101010001010101
101011101010101010101111111011111111101110111010101
101010001010001010100000100010000000001000100010001
101010111011111010111010101110111111101011111011111
101010101000100010001010100010100000101000001010001
101110101110101111101110101010101111101111101010101
100010101000101000100000101000101000000000101000101
101010101011101010111111101111101011111111101111101
101000100000101010100000101000001000000000100010001
101111111111101010111110101110101111111110111010101
101000000000101010000010100000100000100000100010105
101111101110101011111010111111111110101110101110111
101000101000101000101000100000001000101000100010001
101010101011101110101110101110111011101111111011101
101010001010001000101000101010000010100000001000101
101011111011101011101011101011111110111111101110101
101000001010001010000010100000100000000000100000101
101011101010111010111110111110101110111111111111101
101010101000100010000000001000100010001000001000001
101010101111101111111111111011111011101011101011101
101000101010000000000000000010100010100010101010001
101110101010111111111111111110101110111110101010111
100010101000000000000010000000100000000010100010001
111011101111111111111011111110111111111010111111101
301000104010000000001000100010000000101010001000001
101110111010111111101110101011101010101010101011101
100010100010100000100000101000101010001010101010001
111010101110111010111111101110111011111011101011111
100010100010001010000000001010001000000000001000001
101110111011101110111111111011101011111111111111101
100010100010100000101000000000101010000000000000001
101010101110111111101011111110101010111011111111101
101010101010000000001000001010101010001010001000001
101010101010111111101111101010101110101110101111101
101000101000100010001010001010100010100000100000101
101111101011101010101010111010111010111111111110101
100000101000101010100010001010000010100010001000101
111110101110101010111111101011111111101010101011101
100000001000001010000000000000000000001000100010001
111111111111111111111111111111111111111111111111111

L
