111111111111111111111111111111111111111111111111111
101000100000001000000010000000100000000000000000001
101010101110111011111010111010101011111111111111101
100010100010100010000010001010101000001010000000101
111110101011101110111010111010101111101010111110101
100010101000001000100010100010100010001000100010001
101110111110111011111110101110111110111011101111111
100010000010100010000010100010000010101010000000001
101011111010101110111010111011111010101010111110111
101000001010100000001000100010001000100010000010001
101111101011111110111110101111101111101111111110101
100000101000000010100010101000001000001000100010101
111111101111111011101011101110111011111010101011101
100010000000101000001000100010100010001010001000001
101010111110101111111110111010101110101011111111101
101000100000100010000000100010001000101000100010001
101111101111111010111111101110111011101110101010111
100000100000000010100000100010100010100000101010001
111110101111111110101011101010101110111111111011101
300000101000000000101010001010100010000000100010001
101111101011111111101010111010101011111010101110111
101000001000000010001000001010101000001010001000101
101011111111111010111111111010111111101011101011101
101010000000100010001000100010000010001000101010001
101110111110101111101010101111111010111110111010111
101000100010001000001010100000001000100010100010001
101011111011111011111110111111101011101010101111101
101000100000101010000010000010001010001010000000001
101110101110101011101011111010111110111011101111111
100010100010001000101000000010000010101000101000005
101010111011111110101111101111101010101110111011101
101010100010000010001000001000101000000010000010001
101010101110101111111011111010111111111011111110101
101010101000100000100010400010100010000000100000101
101010101011111010101110111110101011111011101111101
101000100010000010101000100000001000001010001000101
101111101110111011101011111111111111101010111110101
101000101000100010001000000000000010001010100010101
101010101011101110111111111111111010111110101010101
101010101000100010100000100010001010000010101000101
101011101110111010111011101010101011111010101111101
101000000010100010100010001000101010001000101000001
101111111010111110101110111111101010101111101011111
100000100010000000001000101000001000100000101000101
111110111110111111111011101011111111101110101110101
100010000010000000100010001010000000100010100000101
101011111010111110101111101011101110111110101111101
101000001010100010100000101010001010001000101000001
101011111011101011111110101010111011101011101110101
101000000000001000000000100000100000000010000000101
111111111111111111111111111111111111111111111111111

R
