111111111111111111111111151111111111111111111111111
101000100010000000001000001000001000000000000000001
101010101011111110101010101011101011111110111111101
100010101000000010101010100010101000000010101000001
111110101111111010101110111110101011111110101011111
100010001000001010100010001000101010000010100010001
111011111011111010111011101011101110111010101110101
100000001000001000101000001000100000100010100000101
101111111011101111101111111110111111101110101111111
100000001010100000100010000000100000101000101000001
101111101010111011101010111011101110101010111011101
101000100000001000101000101000001000101010000000101
101010111111101110101111101111111010101110111111101
100010001000100010100010000000001010100010100010001
101111111010111110111010111011101010111010101010111
101000000010000000001010100010001010101010001010001
101011111111111110111010101110111010101011111111101
101000001000000000100010101000001010001010000010001
101111101111111111101110101111101011111010111010111
101000101000001000001000101000101000001000101010001
101110101011101011111011101010101111101111101010101
100010101010101010001010100010100010001000000010101
111010101010101010111010111110111010101011111111101
100010100010100010000000001000100010101000100000001
101110111110111111111110111011111110101110101111101
101000000000000010001000100010000000100010100000101
101111101111111010101111101010111111111010111110101
100010001000001000100000101010100010000010100010101
111010111011101111111110101010101011111010101010111
100010001000100010000010001010001000001010101010001
101111101011111010101111111011111111101110101011101
100000100010000010100000100010001000100010101000001
111110101110111110111011101110101010111010101111101
100000100010100000001000000000100010001000100010001
101111111010111111111111111111111111101111101011101
101000000010000000000000000000001000100010001000101
101111111011111111111111111111101010111011111110101
100000001000001010000000000000101010001000001000101
111111101111101010101111111011101111101111101011101
101000100000101000100010000010001000000010101010101
101010111110101110111011111010111011111010101010101
100010000010100010101000001010100010001000101010001
111110111110111010101111101110111010101011101011101
100010100000100010001000001000100010101010001000101
101010101111101111111011101011101110101110111010111
101010101000000000000010001010000000100000100010001
101010101111111111111111111010111111111111111110101
101000100010000000140000000010100000000000000010101
101111111010111110101111111110111110111111111011101
100000000000100000001000000000000000100000000000001
111111111111111111111111111113111111111111111111111

D
