111111111111111111111111111111111111111111111511111
100000001000100000001000000000000010000000000000001
111111101110101110111011111011111010111111101111101
100000101000100010001000101000001010001000100010101
101111101011111011101110101111101011111010111010101
101000101000001010001010101000001000000010001010001
101010101011101010101010101011111111111111101010111
100010001010001010100010001000101000000000101010001
101111111110111010101111101110101011111110101011101
101000001000100010101000001010100000100000101010001
101011101011101110111011111010111110101110101010111
101010001000001010100000000010000010100010100010101
101010111011111010101111111111101011101011111110101
100010101010001010001010000000101000101010000010001
111110101010101011111010111110111110101010111011101
100010100000100010100010000010000000101000100010001
101010111111111010101011111011111111101111101010111
101010001010001010001000001010000000100010001010101
101011101010101011111011111010101110111110111010101
101000101000100010001000100010101000000000100010101
101110101111101110101110101110101111111110111110101
101010100000101000100000101000100000100000100010001
101010111110101110111110101011111110111111101011101
101010000000100010100010101010000010000000001000101
101011111111111010101011101011101011111111111110101
101000000010001000101000101000101000001000101000101
101110111010101111101110101110111110101010101011101
100010001000100010001000100010000000101010001000001
111010101111111010111011101011111111101011111111111
101010100000101010001010001010000000101000000000001
101011111110101010101011111011101110101011111110101
101010000010100010101010001000101000101010000000101
101010111010101110101010101110101011101110111111101
101010001010101000101000100000101010101000100000001
101011101010101111101111111111101010101011101111111
101010001000101000101000000000001010100010100010001
101010111111101010101110111110111010111110111010101
100010000010000010100010000010001000101000000010101
101110111011111110111011111011101110101011111110111
101000001000001000100010001010101000001010000010001
101111111110101011101111101010101111101010111010101
101000000010101010000000101000100000101000100010101
101011111011101010111110101110111110111111101111101
101000001000001010001004100000101000100000100000101
101111101111111011101011101111101011101110111110101
100000100000100010001010101000001000000010100010101
111110111110101111111010101111101111111110101010101
100010001000101000001010001000000010100000101000101
101011101011101110101010111011111010101111101111101
101000000010000000100010000010000000100000000000001
111111111111111113111111111111111111111111111111111

U
