111111111111111111111111111111111111111111111111111
101000000010000010001000000000100000000000100000001
101110101110101011101011101111101111101011101111101
100010100000101000001000100000001000101010000000101
111010111111101111111110111111111010101110111111101
100010001010001000000000100000100010100000101000001
101111101010101011111111101110111011111111101011101
101000101010101010000000000010001000000010001000101
101010101010111011101111101011101010111010101110111
101010000010000000101000101010101010001010100010001
101011111111111110111010101010101011101110101111101
101010000000100010000010101010001010101000100000101
101010111110101011111110111011101010101011111011101
101010100010001000100010001000101000100000001010001
101110101111111110101011101110101111111111111010111
101000101000000010101000100010100000000000001010001
101011101011111010111010111010111111111111101011101
100010100010100010001010100010100010000010000010001
111110101110101111101010101110111010111010111110101
500000100010100000001010100010001010101010100000101
101111111010111111111010111011101010101010101111111
101000000010100010000010001000001000101000100000001
101011111110101010111011101111111011101111111111101
100010000010001010001010100010001000000000100000103
101110101010111010111010101110101011111110101011101
101000101010001010100010001000100010000010101000101
101110101110111010101110111011111110111010111110101
100010101000100010101000001000100000100010000000101
111011101011101110101111111011101111101110111111101
100010001010100000100000000010001000000010100000101
101110111010111111111111111110111111111010101110101
101000000000000010000000100010000000001010101010101
101110111111111011111010101011111111101011101010101
100010101000100000001010001000000000101000101010101
111010101010111111101011111110111111101110101010101
100010101010001000101000001000100000001000101010101
101110101011101011101111111011101111111011101010101
101000001010001000101000000010001000100010001000101
101111111010111110101011101110111011101110101110101
100000000010000010000010001000100000100010100010001
111111111111111011111110111011111110111011101011101
100000100000001000100010101010000000001000101010001
101110111110101110111010101011101110111110111410111
101000000000100010001000001010001000100010100010001
101111111111111111101011111010101111101010101111101
100000000010000000101000100010101000101010001000101
101111111010111011101111101110101010101011111010101
100000101010101010001000001000101010001000000010001
111110101010101010111011111011111011111111111111111
100000001000001000000010000000000000000000000000001
111111111111111111111111111111111111111111111111111

D
