111111111111111111111111111111111111111111111111111
100000100000000000100010100000000000001010000000001
111110111011111010101010101010111111101010111011111
100010001010000010101000101010100010100010100010001
101011101010111110101111101011101010101110101110101
101000001010000010100000001000001010001000100000101
101111111110111010111011111111101011111011111111101
501000000010001010001010000000101010001000001000101
101111101010111011101110111110101010101111101010101
100000001010100010000000100000101000100000000010101
111111111010101111111011111011111111111111111111101
100000100010100000001010001000000000000010000000401
101110101110111111101110101111111111111010111111101
101010101000000000100000101000000000001010000010001
101010101111111110111110101110101111101010111011101
101000100000000010100010100010100000101010001000101
101111111111111011101011111011111010111011101110101
100000001010001000001000001010001010100010001010101
101110101010101111111111101010101110101110111010101
101000100010100000000000100010100000101000000010101
101011111010111111111110111110111111101110111110101
101000100010000000001000100010000000100010100000101
101110101111111111101010111010111110111011101111101
100010100010000000101010000010101000001000001010001
111010111110101111101011101110101011111111111010111
100010000000100000001000101000001010000010000010003
101111111111111111111110111011111010111010111011101
101000000010000000100010000010000010001010101000101
101110101010101110101011111110111111101010101110101
100010101010100010001010000010000010001000001000101
111011101010111011111010111010111010111111101010101
101000001010101010000010101010001000001000101010101
101111111010101011111110101011101111111010111011101
100000000010001010000000101010000000100010000010001
111111101111111010111111101011111111101111111010111
100000100000000010100000001000000010001000001010001
101110101111111110111111101111111010111011101111101
100010101000100000100000000000001010001010100000101
101010111010101111101111111111111011101010111011101
101010000010001000000000000010000000001010001000001
101011111111111011111111111010111111111011101111111
101000001000000000001000001000000010000010001000001
101111101011111111101110111111101110111110111011101
100010001010000000100000100010001000100010000010001
101110111010111110111111101010111011111010111110101
101000100010100010000000101010001000001000001010101
101011111110111011111110101011111111101111101010101
101000100010001000000010001000100000100000100010101
101110101011101111111011111110101011111110111110101
100010001000000000000000000010001000000000000000101
111111111111111111111111111111111111111111111111111

L
