111111111111111111111111111111111111111111111511111
100010000010000000000000000010000010000010001000001
111010111010111111111111101110101010101011101010111
101000101010100000101000001000101010101000100010001
101111101010101110101011111011101011101110111111101
100000001010001000101000000010001000101010100000101
101111101011111011101111111010111110101010101110101
100010001010000000001000001010000010001010001010001
101011101011111111101011101111101011111011111011101
101000101000000000101000100000101010000000100000101
111110111111111110111110111110111010111010101011101
100010100000000010000000101000100010001010101000001
101010101111101111111111101011101111111010101111111
101000100010100000001000001000001000000010100010001
101111111010111011101011101111111010111110111011101
100000000000001010100010001000001010001000001000101
101111111111111010111110111010111011101011111110101
100000000010000010000000001010000010001010100010001
101111111110111110111111111011111110111010101011101
101000100000100010100010000010001000101000101000101
101010101111111010111010111111101011101110101110101
101010101000001000000010001000001000100000100010001
111010101011101111111011101110101110111111111011111
100010001000100010001000100010100010000000001000001
101111111011111010101111111010111111111110111111101
101000000010001000100010000010000000000010001000001
101011111110101111111010111111111010111011101011111
100010000010100010000010000000001010001000100010001
101110101110111010111011111111101011101011111111101
100010100010001000101000001000101010001010000000101
111011111011101111101111101010101010111010101110101
100010001000100010000000100010101010001010101000101
101110101110111011111110111110101111101110101011101
101000100010001000001000001000100000100010101000101
101010111010111111101011111011111110101010101110101
101010001000100000001000000010001000101000100010001
101111101011101111111011111110101011101111111011101
100010001010001000001000100000101000101000001010001
111010111110101111101110101011111110101110101010111
100000100000101000100000001010000010100010101010101
101111101011111010111111111110111010111010111010101
101010001010001010000000000000001010100000100010001
101010111110101011111111111111111010111111101111101
100010000000100010001000001000000010000000100010001
111011111111111110101111101011111111111110101011111
100010000000000000100000101000100010000010101000001
101110111110111011111110101110101010111010101111101
101000100010001410100000100010001010101000100000101
101111101011111010101111101011111010101111111111101
100000001000000010000000001000001000000000000000001
111111111111111111111113111111111111111111111111111

D
