111111111111111111111111111111111111111111111111111
301000000000001000000010000000100000000010000000001
101111101110101111101010101111101011111011111011101
100000100010101000001010100000001000100000001000101
111110101110101011111011111110111110111111101110101
100010101000100010001000000010001010001000001000101
111010111011111111101111111011101011101011111011101
100010001000001000000010001000100010001010000010001
101111101111101010101110101110101110111011111011111
101000100000001010101000100010101000101000001000001
101010111111111010111011101110111011101111101111101
101010100000001010000010001000100010000000100000101
101010101011101011111110101011101110111010111110101
100010001010001010000010101010001000001010100000101
101111111010111010111010111010111011111010101111101
100010100010101010001010140010001010000010100000101
111010101110101011111010101111101010111111111110101
101010100010001000000010101000001010001000000000101
101010111011101111111010101011111111101011111111101
101000100010001000100010001010000000001010000010001
101110101111101110101111111010111011101010111010101
100000100000100010101000000010001000101000101000101
101111111110111010101011111111101110101111101111101
100000000010001000101000100000000010100010000000101
111111101111101111101110111111111110111110111110101
100000001000001000001000100000000000100010000010005
101111111010111011111011101111111110101011111011111
101000001010100010000010001000001000101000001010001
101111101010101110101111101011101111101011101010101
100010001010100010101000001010101000101000101010101
111010111010111011101011111010101010101110111010101
101000100010001000101000100010100010100010000010101
101011101111101110101110101110111110111011111111101
100010001000101010100010101000000010000010000000101
101110111011101010111010101011111111111111111010101
100010100000100010100010001000000000000000000010001
111010111110111010101110111111111110111011111111101
100010000010000010001000100000000010101010000010001
101111111011111111111011101111111010101010111010111
100010000010000000001000001000001010001010001010101
111110111010111111101111111010101011111011101110101
100000101010100010000010000010101000001000100000101
101111101010101110111110111110101111101010101111101
101000000010100010000000100010101000001010100000101
101111101110111011111111111010111011111110111110101
100000100010000010000000000010001000000010001010101
101110111111111011111011111011101111111011101010101
100010001000001010001000100010101000001000001010001
111011101010111010101110101110101010111111111011101
100000100010000000100000100000100010000000000000001
111111111111111111111111111111111111111111111111111

D
