111111111111111111111111111111111111111113111111111
100000100000001000001010000010000000000010000000041
111110111010111010101010111010111110111011101111101
100010100010100010100010001000001000101000100010001
101010101111101110111111101111111011101110111110111
101000100000000010000000001000100010000010100010001
101111111011111110111111111011101110101010101011101
100000001000100010001000001000100010101010001010001
111111101111101011101011101110111011101111111010101
100000100000001000100010101000101000100000001000101
111110111111111110111110101010101110111110111111101
100000000000000010000010100010000010100010100000101
101111101111111111111010111110111110101010101010101
101000001000000000001010001000100000101010001010101
101111111011111111101010111011101111101011111011101
101000000010000000101010001000100000001000001000101
101011111110111111101011101110111111111111101110101
101010000000100000001010001010000000100010100010001
101010101111101111111010101011111110101010111011101
101000101000001000001010100000100010001000001000101
101110111010111011101010111111101011111110111110101
100010100010100010100010000010001000100000100010101
101110101110101110111110111010111110101111101010101
101000101000100010001000001000100010001010001000101
101011101111111010111011111111101010111010111111101
100010001000001010000010000010001010001010000000101
111110101010111010111110111010111011101011111110111
100000101010001010000010001000100010000000000010001
101111101011101011111111101111101111111111111111101
100010001010001010000000001000001000000000000000101
111011111010111010111111111011111011111111111110101
100010000010001000100010001010000000001000100010001
101110111111101111101011101010111111101110101011101
101000100000100000001000001010100000100010101000001
101011101110111011111111111010111110111010101111111
101010101010001000001000100010000000001010101000001
101010101011101111101010101111111110111010101011111
101010101000100000100010100000100000100010000010001
101010101011111110111110111110101111101111111110101
100010000010000000100010000000100010001000000000101
101110111110111110111011111111111010101011111110101
101000100000100010000000000010001010101010000010101
101011101111101111111111111011101010111010111010101
101000100000100000000000000010001010000010101010101
101111101110101111111111111110101011111110101011101
101000101000100010000010100000101010001000101000001
101010101011111010111010101011111010101011101111101
100010101000101010100010001000000000101010000000101
111110111110101010101111111111111111111010111111101
100000000000100000100000000000000000000010000000001
111111111111111111111115111111111111111111111111111

D
