111111111111111111111111111113111111111111111111111
101000000010000010001000100000001000001000000000001
101110111110111010101010101110101110101111101011111
100010100000101000100010100010101000100000101010001
111010101111101111111110111010101011111110101110101
100010001000000000001010000010100010000010101000101
101110111011111011101011111010111110111010101011101
100010001010001010101010001010100010001000101000101
111011101010111010101010101010101011101111101110101
100010001000100010000010101010001000101000100000101
101110111111101110111110101011111110101010111110101
101000000010001000101000101010000010101010100010101
101111111010111110101011101010101110101010101011101
100000001010100010001010001000101000100010001000001
111111101010101011111010111111101011111011111111101
100000101000101000001010100000101010000010001000101
101111101110101111101010101110111010111110101110101
100010001000100000100010001000100010001000101000101
111010111011111110111111111011101111101011101011101
100010001010100000100000000010004010001010001000001
101111101010101111101111111110111010111010111011111
100000001010101000000000001000100010001010100000001
101111111010101011111111101011101111111010111111101
101000001000101000100010101000100000000010000000101
101011101110101111101010101111111110111111111110111
101000101000100000001010000000100010100000000010001
101110101011111111111011111110101010101111111011101
100010101000100010001000100010001010100010000000001
111010101110101110101110101011111010111010111111111
101010101000100000100010101010001010001010100000001
101010101011111111101010101110101011111011101111101
101000101000001000001010100000100000001000001000001
101111101111101011111010111111111111101011111011101
100010001000100010000010000000001000001010001010001
101110111010111110111111111111101011111110101010111
100000100010100010000010000000001000001000100010001
101111101110111011111010111111111111101011111111101
100010100010000000100010100000100000101010001000101
111010101010111111101110111010101110101010101011101
101010001010100000001010001010001000100010100010001
101011111011101111111011101011111011111110111110111
100010001000001000000000101010001000000000001000101
101110101011111111111010101011101111111111101011101
100000101000000000000010101000100000100000100010001
111111101011111111111011101110101110101010111111101
100000101010001000000010001010101010001010001000101
101111101110101110111110111010101011111011101010101
100000001000100010100010100000100000001010100010101
101111111011111011101010101111111111111010111110101
100000000010000000001000100000000000000010000000001
151111111111111111111111111111111111111111111111111

R
