111111111111111111111111111111111111111111111111111
101000000000001000001000000000000010000000000010001
101111111011101011101011111111101110101011111011101
100000001000101000101010100000100000101010001000101
111111101111101110101010101110101111101110101110101
100000100000101000101010101010100000100000101000101
111110111110101011101010101010111011111111101011101
100000001000101000100000101010100010000010001000103
101110111011101011111111101010111110111010111110101
100010100010100010000000001010000010001000100010101
111011101110101110111111111011111011101111101114101
100010001000001010101000000010000010001000100000101
101010111111101010101011111010111110111011101111101
101010100000100010100010000010100000100000100000001
101110101110111010111110101110111110101110111111101
101000101010001010000010101000100010100010001000001
101011101011101110111010111011101010101110111011111
101000101000100010100010000010001000101000100010001
101110101010111011101110111110101111101011101110111
100010001010001000001010100000100010001000101000001
111011111011101111111010101111111010111110101111101
100010000000101000000010101000001010001000100000001
101110111110101011111010101011101011111011111111101
101000100000101000101000101000101000001000000010001
101011101111101110101111111010101111101010111110111
100010001000000010100000001010101000101010100000101
101110101111111010101111101110101010101010101111101
100010101000100010001010001000100010001010000010001
111110111010111111111010111011111111101111111010101
100000100010000010000010100010000000101000101010101
101111101111111010101110101110111011101010101011101
101000100010001000100000100010100010001010101000101
101010111010101111111111111010101110111010101110101
500010001010100000000010000010100000100010100010001
101110101010101111111010101110111111101110101111101
100010101010100000101010101010001000000010101000001
111110101010111110101010101011101011111110101011111
100000101010001010101010101000001000100000101010001
101111111011101010101010101011111011101111101010101
100000001000100010101010101000001010001000100010101
101111101110111110101011101110111010111010101110101
101000100010000000101000100010100010001010001000101
101010101111111111101110101011101111101111111011101
101010001000001010000000101000101000100000000010001
101011111010101010111111111110101110111111111110101
101000000010100010100000000010000000101000001000101
101111111110111110111111101011111110101011101011101
100010000010100010001000001000000010001010001010101
111011101010101011101011111111111011111010111010101
100000001010001000000010000000000000000010000010001
111111111111111111111111111111111111111111111111111

U
