111111111111111111111111111111111111111115111111111
101000001000000000100000100010001000000000100000001
101011101110101110111010101010101011111010111111101
100010100010101000001010101000100000100010000000001
111110111011101111101010111111111011101111111111101
101000001000101000101010001000001010001000000010001
101010111110101010101011101011101110111011111110111
100010100010100010101010001010000000101000001000101
101110101010111110101010111010111111101011101011101
101000101010001000100010000010001000100000100010001
101011101011101011101111111111111010111110111110101
101000001000001000101000000010000010001010001010101
101111111111111010111011111010111111101011101010101
101010000000000010100000001000100010001000001000101
101010111111111110101111111110101010111011111110101
101000000000100010100010000010001010100000000010101
101111111110101010111010111010111110101111111010101
100010001000101010001010101010100000101000001010101
111010111011101011101010101011101111101011101011101
101010100010001000100010100010001000001010101000001
101010101110111111111110101110111011111010101111101
100010000000100000000000100000100000001010101010001
101111111110101111111111101111101111111010101010111
100000000010100000001000001000100010401000101010101
111111111010111111101111101010111010101110101010101
100000001010000000100000101010101010100010101000001
101111111011111110111110111010101010111010101111101
100010000010000010100010100010100010001000100010001
101010111111101010101110101110101111101111111011101
101010000000101000100010001000101000000000001000101
101011111110101111101011111011111011111111111110101
101000001000100010001000001000001010001000000000101
101011101011111010111111101111101010111011101111101
101000101010001010000010100000100010001000101000101
111110111010111011111010101111111110101110111010101
100000100010000010000000100000000010100010000010101
101110101111101110111111111110111011111011111110101
101000101000100010000010000010001000000010001010101
101111101010111011111010111011101111111010101010111
100000001010101010001010100000001000001000100010001
101111111010101011101010111111111110111111111011101
101000000010100000100010000000100000100010001000101
101011111010111110111111111110101111101010101110101
101010001010000010000000000010100000001000100000101
101110101011111011111111111010101111111111111111101
100000101000001000100000100000101000001000100010001
111111101011101110101110111111101011101010101010101
100010001000101010101010000000100010001010001000101
101110111111101010101011111110111111111011111111101
100000000000001000001000000000000000000010000000001
111111111111111111111113111111111111111111111111111

L
