111111151111111111111111111111111111111111111111111
100000001000001000000000000000000010000010000010001
111111101011111010101111101111111110101011101010101
100010001000100010101000101000001000101000101010101
101110111110101110111010111011101011101110101110101
100000100000100010000010000000100000101000100000101
101111101110111011111111111111111111101011101111101
101010000010001000000000000010000000001010100000101
101010111011111110111111111010111111111010111011101
101010001010000000100000001010000000100010100010001
101011101010111111101111101111111110101110101110101
101000001000100000101000100000100000101010000010101
101111101111101110101010111110101111101010111110101
101000100000101010001010000010101000101000100000101
101010111111101011111111111010101010101011101111101
100010000000001000000000100010001010101010001000001
111111111111111011101110101111111010101010111110111
100000100000001000101000001000001010001010100010101
101010101111101110101111101011101011111010101010101
101010101000101000100010101000100010001010001010001
101011101110101011111010101110111110111011111011111
101000100010100000100010000010101000100010001000001
101110111010111111101110111110101010101111101111101
100010001000100000001000001040101010000000001000001
111011101011101111111111111011101011111011111011101
101010101010001000000010000010001010001010000010101
101010101010111011111010111110111010101010111110101
101010100010000010001000101000000010101010001000001
101010111111111110101111101011111110101011101110111
101000100000001000100000001000100010101000100010001
101110111110111011111111101110101010101111101011101
100010000010000010100000100000101000101000101010001
101111111010111110101110111111101111101010101011101
100000000010100000101010000010001000101010101000101
101111111110101011101011101010111010101010111110101
100010000010101000100010001010100010100010001000101
111010111010111010101110111010101010111111101011101
101000100010001010001000100010101010100000100010101
101111101111101111111011111110101011101110111110101
100000101000100010000010001000101000001010000000101
101110101011111010111110101011101111111011101111101
100010001000000010001000101010001000000010100000001
111011111111101111101011101010111111101010111111111
101010000000100000101000100010100000101010000010001
101010101110111110101110111110111010101010111010101
100010101010001000101000100010000010101010001000101
101110101011101110101011101111111110101011111111101
101000101000100010001010100000100010001000100000001
101111101010111011111010101110101011111110101111101
100000001010000000000010000010001000000000001000001
111111111113111111111111111111111111111111111111111

R
