111111111111111111111111111111111111111111111111111
100010001000100000000010000000001010000000000000001
111011101010101011111010111111101010101111111111101
101000100010001010001000100000001010100000001000101
101110101111111010101111101111111010111111101010111
100000101000000010100000101000000000101000100010001
101111111011111110111110101011111111101010111111101
101000001010000010001010001000000010000010000010101
101011101010101011101011111111111011111111101010101
101010101010101000101000000000101000001000001000101
101010101011101110101111101110101111101011111110101
101010101010001000100010001000001000101010000010101
101010101010111111111010111111111010101010111010101
100010101010001000000010100000000010000010001000101
111110101011101011111110101111111111111110111111101
101000100010001000100010101000000000001000100000001
101010111110111110101010101011111111101111101111101
100010000000100000101010001010100000100000001000001
101111111110101111101011101010101011111111111011111
101000001000101000001000101010001000100000001000001
101011111010101111101110111010111110101110101111101
101010000010100000001010000010100010001010100010001
101010111011111111111011111110101111111010111110111
500010001010000000000000100000101000000010100010101
111011101010111111101110101111101011101010101010101
101010101010100000101000100000100000101010001000101
101010101110101110101111111110111110101111111111101
100010100010101000100000000010001000100000001000001
101110111010101010111111111011101011111110101110101
101000100010101010000000100010101010000010100000101
101010101110111011111111101010101010111010111111101
100010100010001000001000001000101010101010001000001
111110111011101111101011111110101110101011101011111
100010001000101000001000100000100000101010001010001
101011101010101011111110111111111111101010111011101
101000001010101000000010000000100000000010100000101
101111111011101111111011111110101111111110111110101
100010001000100000100000001010001000100010001010101
111010101010111110101111101011111010101011101010101
100010101010001000100000100000000010101000041010101
101110101110101011101110111111111110101111111010101
100010100010101010100010001000000010001000100000101
111010111010111010111011101011111011111010101111101
100010001000100010000010001000001000000010101000001
101111101111101111111110111111101011101111101011111
100010100000001000000010000000101000101000101000003
111010111111111011111011111010101110101010101011101
100010000010001010001000001010100010101010001000101
101111101010101010111111101110111010111011111111101
100000001000100010000000000000100010000000000000001
111111111111111111111111111111111111111111111111111

L
