111111151111111111111111111111111111111111111111111
101000001000100000001000001000000000000000001000101
101110101110101011101011101111111010111111101010101
100000100010001010100010100000001010001000101010001
111111111010111010111110111111101011101011101011101
100010001010001010000000100000101010001000000010001
101010101011101011111110101011101110111111111110111
101010101010101010000010001000101000100000100010101
101010101010101010111011101110101011101110101010101
101010101010101010001000100010001010000010101010101
101110101010101010111110111011111010111110101010101
100000101010001000100000101000100000001000101000101
101111101011111011101111101110111011111011101111101
101000001000001010001000000010001010001010000000101
111010111111101110111010111111101110101011111110101
100010100000001000100010100000001000101000001000101
101011101111111011111110101111111011101111101011101
101010001000001010000000100010000010001000001000101
101110111110101010101110111011101110111011111110101
100000100000101010100010001000101010100010000010001
101111101011101011111011101110101010101110111111101
100010001000100010001000101000101000101000000000001
111011111010111110101110101011101011101111101111111
101010001010001000100000101000001010000000100000001
101010101111101011111111101111111011101110111111101
101010100000001010001000001000001000100010100000101
101010111111111010111011111011111110111110101011101
101000100000001010000010001000000010001000101000001
101111101111101010111110111011101111101011101111101
101000001000100010100010000000100000101010001000101
101011101010111110101110111111111011101011111010111
101010101010100000100010100000001010001000100010001
101010101110101111111010101111101010111110101111101
100010100010101000001010100010001010000010001000001
101110111010101110101010111010111011111011101011111
100010001010100000101000101010001000001000101000001
111010111010111111101011101011101011101110101111101
101010001010000000101000001000101010001000101000001
101011101011111010101111111110101110101011111011101
100010001000001010001000000000100000101010000010101
101110101111101110111011111111111111101010111110101
101000100000100010001010000010001000001000101000101
101010111111101011101010111010101111111111101010101
101010001000101000101010001010101000000010000010101
101111101010111110101011101010101011101011111110101
101000001010000000101010001000100010001000000000101
101011111011111111101010111111111110111111111011101
101000001000100000000010000010000010100000001010001
101111101110111111111111111011111010101111101110111
100000000010000040000000000000000010000000100000001
111111111111111311111111111111111111111111111111111

R
