111111111111111111111111111111111111111511111111111
101000001000101000000000100000000010000000000000001
101110101010101010111111101011111110111011111111101
101000100010100010000010001000000010001000100000101
101011111110101111111010111111111011101110101110101
100010000010101000101000100000001000101010100010101
111110101010101010101111101111101110101010111110101
100000101010100010000010001000100010000010000010001
101111101010111111111010101010111111111011111010111
101000001010001000100010101010000010001000001010001
101011111011101110101110111011111010101111111011111
101000001000100010101000100010100010100000001000001
101111101110111010101110101110101110111111101111101
101000101000001010001000101010001000100000100000101
101010101111101011101010101010111011101110111110101
100010100000101000100010101000100000001010000010101
111111111010101110111111101011111011111011111010101
100000001010100010000000001000001000000010100010001
101111101110111011111111111111101111111010101111101
101000100000100010000010000000101000101010100000101
101010111111101111101011101111101010101010111110111
100010000010001000001000001000001010100000000010001
101111111010111110111110111011111010101111111111101
100000100010000010001010100010000010101000000000101
111110101111111011101010101110101110101011111110101
100010100000100010001000101000100010101000001010101
111010111110111010111110101011111010111111101010101
100010000010001010000010101000001010000000001000101
101111111011101011111010101111111011111111111011101
100000001000101000000010100000100010000000101000101
101111101110101110111111111110101110111010101110101
100000100010100010100000000010001000100010000010101
111110101110111011101111111011111011101110111110101
100010100010101010000010000000100000101000100000101
101010111010101010111110111111101111101011101111101
101010001000101000001000100010000010001010101000001
111011101111101111111010101010111110111010101011101
100010001000001000100010101010100004100000101000101
101110111011101110101110101010101111111110101111101
100000100010101000101000101010101000100010101000001
101111101010101011101111101010101010101011101011101
101000001010100010001000001000100010001000100010001
101111101010111010111011111111111111111110111110111
101000101010100010000010001000000010000010000010001
101010111010101111111110101011111010111011111011101
100010000010100000100000101000001000100010001010001
111111111110111110101111101110101111101110101010111
100010001000000000100010100010101000001010100010101
101110101011111111111010111011101011111010111110101
100000100000000000000010000000001000000010000000001
111111111311111111111111111111111111111111111111111

L
