111111111111111111111111111111111111111111111111111
100010000010000000001000000000001000000000001000001
111010111011111011101011101111101011111011101111101
101000101010001000101000100010001010001010000000003
101111101010101110101011111010111110101011111111101
100010001010100000101010000010000000101000100000101
101010101010111111101010111111111111101010101111101
101010100010100010001010100000100000001010100010001
101010111110111010111110101111101111111110111010111
101000100000001010000000101000100000000010001010001
101111111011101011111111101010111111111011101011101
500000001000101000100010100010001000001010001000001
111111101111101010101010101110101011101010111011111
100010001000001010001010101010100010101000101010001
111010111011111011111010101010111110101111101010101
100010100010001000001000100010100000001000001010101
101110101010101011101110111010111011111011101011101
100000101000101010100010001010001010001010001000101
101111101111101010111011111011101010101010111110101
100000101000001000001000001010101000100010000010101
111110111011111111111011101010101111111111111010101
100010001010000000001000101010101000100000000010101
101111101010111111101110101010101010111111111010101
100000101010100000100010100010101010001000001010101
111010101010101010111010111110101011101011101110101
100010101000101010100010000000101000101000100010101
101111101011101010101111111110101110101110111010101
101000101010001010100000100000100000100000001010101
101010101010111011111110111111111110111111111010101
100010101010001000000010000010000010001000000010001
101110101011111110101111101010111011101010111111101
141010001000100010101000101010100010001010100010001
101011111110101010101010111010101111101011101010111
101000000010101000101010000010100000101000001010001
101111101010101110111011111110111110111111111011101
100000101010001010100010001000001000000000100010101
111110101111111010101110101011101111111110101010101
100010100000000010100000101010101000100010001010101
101010101111101110111111101010101010101011111010101
101010101000100000100000001000100010101000001010101
101110101011111011101111111110111110101111111010101
100000100010001000100000100000101000100000000010101
101111101110101110111110101111101011111111111010101
101000001000101000001000100000101000100000001000101
101111111011101111101011111110101110101111101111101
101000000010101000101000000010001010001000100000001
101011111110101010101111111011101011111011111111111
101000001000100010100000100010101000000000000000101
101111101010111110111111101110101111111111111010101
100000001010000000000000001000000000000000000010001
111111111111111111111111111111111111111111111111111

U
