131111111111111111111111111111111111111111111111111
100000000010000000000000000010100000100000000000001
111111111010111111111111111010101110101110111111111
101000001010101000100000000010101010001010100000001
101011101010101010101111111110101011111010101111101
101010001000100010001000000010001000100010101000001
101010111111101111111011101110111010101010101011111
100010100000100010000000100010001010001010001000001
101110101110111010111111111011101011111111111111101
101010000010001010000010000000101000001000000000001
101011111110101011111110111111101111101011111111101
100000001000101000000010000000100000001000101000101
111111101011101111111010111110111111101110101010101
100000001010001000100010100010001000001010100010101
101111111010111010101110111010101011111010101110101
101010000010100010101010000010101000000010100010101
101010111011101110101011111010101111101110111110101
101010001010001010101010001010101010001000100010001
101011101010111010101010101010101010111011101011101
100000101010000010101000100010100010001000001000101
111111101111111010101111101110111111101111111110101
100000001000000010100000101000100000001000100010101
101111111011111110111110101011101111111010101010111
100000004010001000100000101000101000000010001010001
101111111110101011101111101110101111111010111111101
101000000010101000100000101010000000000010100000101
101110111011101110111110101011111111111110101110101
100000100010000010000000100000100000100000100010101
111111101110111111111111111011101110101111111010101
100000100010000000000010001010001000100010001010001
101110111010111111101110101010111011111110101011101
100010000010100000100010100010101000100000100010101
111011111110101110111010111110101110101111111110101
100010001000100010101000001000100010100010000010001
101110101011101010101111111011101110101010101110111
101000101010001010101000001010000000101010101000101
101110101011111010101011101010111111111011101011101
101000101010000010001000100010001000001000100000101
101011101010111011111110111111101011101110111110101
101010001010100010001000101000001000100010000010001
101011111010111110101011101011111110111011111011101
101000001010100000100010001000100010101010001010001
101110101010101111111110111110101010101010101011101
100010101000101000001000000010001010100000101000101
111011101110101011101011101111111010111111101010101
101000100000101010001000100000100010001000001010101
101110111011101010111110111011101111101011111110101
100010001010001010100010101000101000101000100000101
101011101110111010101010101110101010101110101111101
101000000000100010001000000010000010001000001000001
151111111111111111111111111111111111111111111111111

L
