111111111111111111111111111111111111111111111111111
100010000000000010000000100000100000100000001000001
111011101111111011101110111010111110101011101011101
101000101000001000101010000010000010101010000010101
101110101010111110101011111111111010101011111110101
100010101010001000101000001000001010001000001000101
101010101110101011101010101011101010111111101110101
101010100010100000101010100010101010000000100010001
111010101011111110101110111110101011111110111011111
100010101000000010001000100010001010000010001000001
101010101111111011111011111010111010111111101111101
101010100010001010001000001000101010000010000000101
101110111110101010111011101110101011111010111111101
100010001000100010000000100010001000001010101000001
101011101011111110111111111011101111101010101011111
101000101000100000101000000010001000101000001010001
111010101110101111101011111110111011101111111010101
100010100000101000101010000010100000100000001010101
101110111111101010101011101010101110111111101010101
101010100000100010001010001010101000001010001000101
101010101010111111101010111110111011101010111111101
101000101010001000001010000010000010000010100000101
101111101010111011111011101011111011111110111010101
101000001010100010001000101000000010000010001010001
101011111010101110111110111111111110111011101011111
100010000010100010000010000010000000100000101000001
111110101111111010111011111010111111101011101011101
100000101000000010001000100010100000001010001010003
101111101011111111111010101110101111111010111010101
101010001000001000000010100000100010001010001014101
101010111111101011111110111111111010101111101110101
101000100000100010000010001000001000100000100010101
101011101110111110111111101011111111111011111010111
101010001010000010000000001000000000001000100010001
101110111010111010111111111011111011101110101111101
500000100010100010000010001000101000100010101000001
101111111010111011111010111110101110111010101011101
101000001010001010000010100000100010100010001010101
101110101011101110111110101111101010111111111010101
100000100010100000100000101000001010000000000010001
111111111010111111111110101110111011111111101111111
100010001010000000000010000000100010000000100010001
101011101011111011111010111111111010111110101010101
101000001000001010001010001000001010101000101010101
101110111111101011101011101011101110101011111010101
100010100000001010001010001010101000101000001000101
101010101111111010111010111010101011101111101011101
101010101000100010001010100010101010000010001010001
101011101010101110101011101110101010111010111110101
101000000010001000100000001000000010001000000000101
111111111111111111111111111111111111111111111111111

D
