111111111111111111111111111111111111111111111111111
101000000000000000000010000000000000000010000000001
101111111111111111101010111111111111111110101111101
100010000000001000001010001000001000000000100010001
111010111111101011111011101011101011111111111010111
101000100000100010001000101010101010100000100010101
101111101110111110111110101010101010101011101110101
100000101000100000000010101000100010001000101000001
101011101010111011101110101110111111111110101111101
101000001010001000101000101000100000100000100010101
111110111011101011101011101011101010101111101010101
100010001010001010001010001010001010101000101010001
101010111010111110101010101011111010101010101011111
101010100010000010101010100000000010001010101000001
101011101111111010111011111110111111111010101111101
101000001000000010001000000010100000001010101000101
101111111011111111101111111011101111101010101010101
100000100000000000001000000010001000100010101010101
101110101111111111111011111110111011111110101010101
101010100010000000001000001000001010001000101010101
101010111010111111101111101111101014101011111010101
100010001010100000100000100010001000100010000010101
111011101110101111101111111010111011111111101110101
101010100000100000100000000010101000000000101010101
101010111111101110111111111110101111111110101010101
101000001000101010000000000000101000000010101010001
101111101110101011111011111111101011101110101011101
100000001000100000001000001000100010100000101010001
101111111011111111101111101011101110111111101010111
100010100010000010001010001000100000000000101000101
111010101010101110111010111110111111111110101011101
100010001000100010100010100010000000000010001010001
101110111111111010101010101011101111111011111010101
100010001000001010101010101000101000100010001000101
111011111011101010111010101110101110101110101111101
101010000010001000000010100010100010001000100010001
101010111110111111111010111010111010111111111010111
101010001000000000100010100010001010000000001010103
101010101111111110111010101111101011111111101010101
100010100000100010001010100000100010001000000010101
101111111010101111101110111110111110101111111110101
101000001010100000100000100000100010101000000010101
101010101110101110111111101110101010101011111010101
101010100000101010000010001000101000101010001010101
101010111111101010111110101111101111101011101010101
501010100010001010000000100000001000101000001000101
101010101010111011111111111111111110101111101111101
101010001010001000000010000010000000100000100010001
101111111011101111101011101011111010111011111010101
100000000010000000001000001000000010001000000000101
111111111111111111111111111111111111111111111111111

U
