111111111111111111111111111111111111111111111111111
101000000000100000000000000000001000000000100010001
101111111010101111101111111011111011111011101010101
100000001010000010100010001010000010001000101000101
111111101111111010111010101010111110111110101111101
100000100000101000001010100010001000000010101000001
101111111110101110111010111111101111111010101011111
101000000000100010100010000000101000100010001000001
101011111111101010101111111111101010101011111111101
100010000000001010100000100010001010101010000010001
101111111011111110111110101010111010101010111110111
101000001000000010000010001010000010001010000010001
101011101111111011111011111011111111111011111011101
101000100000001000001010001000100000001000100000103
101010111111101010111010111011101011101110101111101
101010001010001010001010001000001000101000101000001
101111101010111011101011101111111110111011101011101
100000101010100010001000000000100010001010001010001
111110101010111010111111111110101111101010101010111
100000101000001010100000100000100000101010101010101
101111101111101010101010101111111110101010101010101
100010000010001010001010100010000000100000101010001
111011111010111011111011111011101110111111111011111
100010000010001000001000001010001010000010001000401
101110111111101110111110111010111011101110101111101
101000000010100010100000100000100000101000100000101
101111101010111010101111101111101011101011111110101
100000101010000010100010001000101000101010000010001
111110111010111111111010111010111110101010101111101
100010001010100000000010001010000010001010100000001
101111101010101111111011101011111011101010111111111
100000100010100000001010001000001000101010100000101
101010111110101111101110111111101110111010101110101
101010100000100010101000001000001000000010001010101
111010101111111010101011111011111111111111111010101
100010101000001000101010000010000010000000101000101
101110101110101111101010111110111010111110101011101
100010100000100000100010100000001000000010101010001
111011111111111110111110101111111111111110101010101
100010000000001000100010000010100000000000101000101
101110101110111011101011111010101111111111101111101
101000101000100010001000101000101000000000000000001
101011101111101110101110101110101111111111111011111
101000100010001000100010100010100000000000001010001
101110111010111111111010101110111111111110101011101
500010001000100000100010101000001000000010101000001
101111101111101110101110101011111011111010101111101
101000101000001010101000100010001000101010101000101
101010101011111010101011111110101110101011101010101
100010000010000000001000000000100000100000001010001
111111111111111111111111111111111111111111111111111

R
