111111111111111111131111111111111111111111111111111
100000100000100000000010000000100000000000100000101
111110101110101011111011111010101111101110101110101
100010100010001000100000001010100010101000100010101
101010111011111110111111101010111010101011111010101
101010100010000010000010000010001000101000000010001
101010111011101111111011111111101111101111111111101
101010001000001000000010000000101000001010000000101
101111101110111010111110111110101011111010111110101
101000101000100010100000100010101010000010001010001
101010101011101011101111101010101010111011101011111
101010001000101010001000001010101010101000100000001
101011111111101010111011101110101010101110111111101
101010000000101010001010101000100010001010001000001
101010111110101111101010101011111111101010101011111
100010100010100000000010001000100000101010101010001
101110101010111111111110111110101110101010111011101
101000101010100000000010100000100010100010001010001
101110111010101111111010101111111010111011101010101
100000100010100000001010101000000010001000101000101
111111101110101111101010101110111110111110101111101
100000001000101000001010100010100010000000100000101
111110111011111011111011111011101011111111111110101
100010001000100010001000000010001010001000000000101
101010101110101110101111111110111010101011101111101
101010100010100010100000000000101000101000101000101
101011111010111011101111111111101111101010111010101
101000000010000010001000000010000000101010001010101
101111111011111110111111111010111011101011101010101
101010000010000000000000001000100010001000101010001
101010111110111111111111101011101110111111101011111
101010100010100000100000101010001000100000001000101
101010101110101110111010101010111011101111101110101
101010100010001010100010101010100010001000001010101
101010111011111010101110101010101111101111101010101
101000001000100010001010101010101000001000100010001
101111101010101111111010101010101011101010111011101
100010001010001000000000101010001010101010100010101
101011101011101011111111101011111010101010111010101
101000100010001010000000001000000010001010001000101
101110111110111010111111111111111011111011101111101
100010100010001010100010000010000010001000100000401
111010101011101010101010111110111110101110111111111
100010001010001010001010000000000010101000100000001
101111111011101011111010111111111010101011111110101
100000001000101010001010100000100010101010000010101
111111101110111010101011101110111110101011101011101
100000100010000010101010001010100010100010001010001
101011111011111111101010111010101010111110111010101
101000000000000000001000000010001000000000100000101
111111111111111111111111111111111111111111151111111

L
