111111131111111111111111111111111111111111111111111
101000000000001000001000000000001000100000000000101
101111101111101010111011101111111010101011111110101
101000100000100010000010100000100010001000001000001
101010111011111011111110111110101111111111101111111
101010001010001010000000100010100000100000100000001
101011101110101011111010111010111110111010111111101
100010100000101000000010001010000010001010100000001
111110111111101111111111101010111111101011101111101
100000000010001010000000100010100400100010001010001
101111111010111010111110111010101010111010111010111
100010000010001000000010001010001010001010100000001
111110111011101111111011101011111011101010111111101
100000101000101000100000101010001000101010000000101
101111101011101010111011101010111110111011111110101
101000001010001010001010001010100010001010000010101
101011111010111011101110111010101011101011111010101
101000000010001010100010000000101000100010000010101
101011111111101010111010111111101110101110111010101
101010000000100010001010100000001010100000100010101
101011111010111111101011101111111010101111101110111
101000100010001000101000001000000000101000100010001
101110101111101010101111111011111111101010111111101
100010001000000010000010000010000010001010000000101
101011111011111111111110111111101011101011111110101
101010000000001000100000101000001000101000100010001
111011111111101010101111101010111110101110101011101
100010001000101010101010000010100010101000101000101
101110101010111010101010111110101110101011101111101
100010100010000010001000100000101000101010000000101
111010111111111111111011101111101011111010111110101
100010100010100000001010001000001000001010000010001
101110101010101111101010111011101111101010111111111
101000101010101000100010100000100000101010100000001
101011101010101010111110101110111110101011101111101
101000001010001010000010100010100000101000000000101
101111111010111011111110111010111011101111111111101
100000000010000010000000100010001000101000000000001
101111111111111110111111101111101110101011111111101
101000000000000000100000101010001000101010000010001
101111111010111111101110101010111111101011111010111
101000001010001000001000101010000000101000001000101
101011101011101111101011101011111110101111101011101
100010101000101000101010101000100000100000001010001
111110101110101010101010101010101110111111111010111
100000101000100010101000101010100010001000001010001
101110101111111110101111101010111011101111101011101
101000100000000010101000101010001010000000001000001
101011111111111010101010101110101011111111111111101
101000000000000000100010000000101000000000000000001
111115111111111111111111111111111111111111111111111

D
