111111111111111111111111111111111111111111111111111
501000000010000040000000100000000000001000000000001
101110111011111011111110101111111110111011111011111
100000100010000010001000100000100010000010001000001
111111101110111110101011111110101011111111101111101
100000100000101000101000001000001010000000001000001
101110111111101011101111101111111011101111111011101
100010001000100000100000101000100000001000001000101
111110101010101111111110101010111011111011101110101
100010101010100010000000100010001010000010101000101
101010101110111010111110111111101010111110101011101
101000100000001010100010100000101010000010001010001
101111111111111010101010101110101110111010111011111
100010000000000010101000101000100010100010001000001
111010111111111110111111101011111011101111101011101
100010100000000010100000001000001000101000101000101
101110111011111110101111111110101110101010101111101
100010001010000000101000001000100010001010101000001
101011101010111011101011111011111111111110101011101
101010001010001010001010001010000000000010101010001
111010111011101110111010101010111011111010101011111
100010000000101000100000101000101000001000101000001
101110111111101011101111101111101111101111101111101
101000100000001000100010000000100000101000100000003
101011101011111110111110111110101111101010111111101
101010001010000010000010100000001000100010000000101
101010111110111011111010111111101010111110111110101
101010000000100000001010000010001010000010001000101
101011111111101111111011111010111011111011111010101
101000100010001000001000100010001000001000001010101
101110111010111011101110101111101111101111101010101
101000100010000000100010001000100010100000100010101
101011101011111111111011111110111010111110111110101
101000001000100000000010000000001010100010001010101
101111111110101111111110111011111010101011101010101
100000000010100010000000100010000010101000001000101
101111111010111010111111101110111110101011111110101
101010000010001010100000100000100000101010000010101
101010101110111010101111111111111010101110111010101
101010101000100010100000000000001010101000100010101
101010101011101010111110101111101010101011101110101
101010101010001010000010101000101010100000101000101
101010111010111111111010101010101110111111101011101
101010001010001000100010100010100000001000001010001
101011101011101010101111111110111111101011111010111
100010101010100010001000100010100000101000001010001
111010101010111111111010101010101011101111101011101
101000101010000010000010101000101000100010001000101
101110101010111011101110101111101110111010111111101
100000100000100000001000001000000010000010000000001
111111111111111111111111111111111111111111111111111

L
