111111111111111111111111111111111111111111111111111
100000100000000010000000000000100010000000100000001
111110101111111010111111101110101010101110111010111
100000101000001010001000100010001010100010001010001
101111101011101011101011111011111011101011101111101
100010101010101000001000001010001000101010100000101
111010101010101111111110101010101110101010111110101
101010001000100010000000101010100010101010000010001
101010111111101010111111101011101110101011111011101
101010000000001010100000101000100000101410001000101
101011111111111010101011101110101111111010101010101
501000000000100010101000001000101000000010101010101
101111111110101110111111111011101111101010101011101
100000100000101000100000000010100010001010101000101
101011101111101010101111111110111010101110101010101
101000001000100010100010000010000010101000101010103
101111111010111110111010111110111110111011101010101
100010000010000010101010000000100000000000101010001
111010111110101110101010111111111111111110101111101
101010101000101000101010100000001000100010100000101
101010101011111011101010111110101010101011111010101
100010101000000010001010000010100010001000001010101
101110101111111110111011111010111111111111101110111
101010001000001000001010001010000000000000100010001
101011101110101111101011101010111111111110111011101
101000001000100000001000101010000000001000101000101
101111101011111111101110101011111111101011101110101
100000101010000000100010100010001000101010000000001
111110101011111010101110101110101011101011111111101
101000100010001010001000100010101010001010000000101
101011111110101111111011111010101010111010111110101
101000001000100000001010001000101010100010100010101
101111101011111111101010101111101010101010101010111
100000100010000000101010100000101000101010001010001
111010111111111110101011111110101011101111111011101
100010001000000010100010000000101000100000000010001
101111111010111010111110111111101111111111111010111
100010001010100000000000100000001000001000001010001
101010101010111011111110101111111011101011101111101
101000100010001010000010100000001000101010100000001
101111111111101110111010111111101110101010111111101
101000000000101000101010100000001000101010000000101
101011111110101011101011101111111011101010111011101
101000000010101000001000100000100010001010001000001
101111111110101111101110111110111010111011101111111
100000100010101000100010000010000010100010001000001
111110101010101010111010111111111110101110111011101
101000101010101010001010000000100010101010001000101
101011101010101011101011111011101010101011101110101
100000001000100000100000001000001000001000000000101
111111111111111111111111111111111111111111111111111

D
