111111111111111111111111111111111111111111111111111
100000001000000000000000000000100000001000100000101
111111101111111111101111111110101011101010101110101
100000001000000000001000000010101010000010001000001
101111111011111111111011111010111011111111111111111
100010000010000000100000100010001000000000000000001
111011101111111010111111101111101111111111111011101
101000101000001010000010001000001000000000001010001
101110101110101011111010101011111011111111101110101
100010100010100010001000101010000010000010100000101
101110111010111110111111101011101010111010111111101
100010001010000010100000001000101000001010000000101
111011101011111010101111111110111111111010111011101
500010101010000010001000000010001000000010001000101
101010101010111110111011101111101011111111101110101
101010101010001000001000100000001000000000101000101
101010101011101110111110111111111111111110101011101
101000101000100010100010100000000000000000101000001
101011101010101011101010101111101111111111101111111
101010001010101000101000100000101000001000100000001
101110111010101110101111111110101011101010111111101
100000101010101000101000000010101010000010000010001
101111101010101011101110111011101010111111111010111
101000000010101000100010001000101010100000100010101
101011111110101110111011101110101011101110101110101
101010000010101000101000100010001010000010101400101
101011101010111010101110111011111010111110111011101
101000001010100010000010000010001000101000100010001
101011111110101111111011111110111011101010101110111
101010000010101000001010001000001010001010100010001
101110111010101011101010101011101010101011111010101
100010101010101000101000101000100010101000100010101
111010101010101011101111111110111111101110101111101
101000101000100010001000000000100000001000100000003
101111101111101110101011111111111011111011111111101
100000100010101010101010000010001010001000001000101
111010101010101010111010101010101010101110101010101
100010101000100010001010101000101000100010101010101
101110101011111011101010101111101111101010101011101
101000001010000010001010101000000000101010100010001
101111111110111110101010101111111110111010111110111
100000000000100010101010100000001010000010000000101
101111111111111010111010111111101011111011111111101
100000100000100010001010001000101000100010000000001
111110111010101011101011101010101011101110111111101
100010100010001010001000101010001010001000100000101
101110101111111010111110111011111010111011101111101
101000101010000010000010100010000010100010001000001
101011101010111111111010101110111010101110101011111
100000001000000000001000001000001000001000100000001
111111111111111111111111111111111111111111111111111

R
