111111111111111111111115111111111111111111111111111
100010100000100000001000000000000010000000000000001
111010101110101011101111111111101011111011111111111
101010001000101010000000100000001010000010000000001
101010111011101011111110101111111010111110111111101
100010001000001000100010101000001010100000100010001
101111101111111110101110101110111010101111111010111
101010001000000010100000100010000010101000000010001
101010111011111010101111101011101110101110111111101
101000001000001010101000001000100010100010001000001
101111101111101110101111111110111010111011101011101
100000100010001000101000100000101010001000001010101
111110111010111011101010101111101010101111101010101
100000100010001010000010001000001010100000001010101
101111101111101011111111111011111010111111111010101
101010000000001000001000100000000010000000100010001
101010111111111111101010101111111111111110101110111
101010001000001000101010100010001000000010101010001
101010111011101010101011111010101110111011101011101
101000100010100010001010000010100010101010001000101
101111101110111111111010111110111010101010111011101
101000001000000000100010001000001000101010100010001
101011111010111110101011101011101111101010111010111
100010000010001000001000101010001000001000100010001
111110111111101111111110101110111011101111101011101
100010001000100010000000100010001010000000001000101
101111101110111011111110111011101010111111111111101
100000100000001000000010001010001010000000000010001
101110111111101111111011101010111110111111111010111
101000100010001000001000101010000010000010001010101
101010111010111010111110111011111011111011101010101
101010000010001010000010000010000010000010001000101
101011111011101011101011111110111110111110101111101
101010100000101010001000001010001000000040101000001
101010101111101010111111101010101111111111101011111
101010001000101010001000001000100000101000001000001
101011111010101011101110111011111110101011111111101
101000001010001010100010001000100000101000001000001
101111101011111010111011101110101111101111101011101
101000101000001000001000100010100010100000100010101
101010101111101111101110111011111010101011111110101
101010100000101000000010001000000010001000000000101
111010111011101011111110101111111111111111101011101
100010000010001000100010100010100000000000001010001
101111111010111111101011111010101110111111111010111
100000100010000000001000100010001010000010000010101
111110101111111111111110101110111011111011101110101
100000101000000000100010001010000010001000100010101
101111111011111011101011111011111011101110111110101
100000000000001000001000000000000000000010000000001
111111111111111111111111111111131111111111111111111

L
