111111111111111111111111111111111111111111111111111
101000100000100000100000000000001000001000001000001
101010111011101110101111111110101111101010111011101
100010001000001000101000100000100000001010000000101
111111101110111011101010101011111111101011111111101
100000100010101000001010101010001000001010000000001
101010111010101111111010101010101011111010111111101
101010001010001010000010101010101010000010100000101
111010111011101010111010101110101110111110111110101
100010100010001000001010100010100000100010000010001
101110101111101011111010111010111111111011111011111
100010100000101000100010001010000000000000101000001
101010111110101111101111111011111111111110101111101
101010100000100010001000100010100000100010001010001
111010101111111010101010101010101110101011101010111
300010101000000010101010001000100010001000001010001
101111101011111110101011111011111011111111111011101
100000001010000000101010001010000010000000000010001
101111111011101111101010101010111111111110111110101
101000001000101000001010100010000000000000100000101
101110111110101011111010111111111111101111101111101
100010000010001010001010001000001000001000101000101
111011111011111011101011111011101011111010101011101
101000100010001000101000001010001000001010001000001
101110101010101110101111101010111111101010111110111
100010101000101010100000100010100000101010100010001
101010101111101010111010111110101010101011101011101
101000100000100010000010100010001010101000001010001
101111101110111111111110111011111011101111111011101
101000001010000000000000001010001000000010001000101
101011111011111111111111101010101111111010101110111
101000001000001000000010001010101000001010100010001
101111101110101011111010111010101011101110111011101
101000000000101010100410000010101000100000101010001
101110111111111010101111101110101010111111101010111
100010100000100010001000001000101010001000100010005
111011101110101110111111111011101111101110101111101
101000100010101000000000000010000000101000100000101
101110101010101011111110111111111110101010111110101
100000101010101010001000100000100010001010001010001
101111101010101110101111101110101111111011101011101
100010001010100000100000001000101000000010000000101
111010111010111111111110111011101010111110111111101
101010100010000000000010001010000010100010001000101
101010101111111111111011111011111110101011101010101
101010100000001000001000001010000000101000001010101
101011111111101010111111101010111111101111111010101
100010001000001010100000101010100010001000001010001
101110101011111011101011101010101011111011101011111
100000100010000000001000000010001000000000100000001
111111111111111111111111111111111111111111111111111

L
