111111111111111111111111111111111111111111111111111
100000000000000010000000001000001000001000100000001
111111111111111010111110101011101011101010111011111
100000000010100010100000101000100010000010001000001
101111111010101110101111101010111110111111101110101
101000001010100010101000101010100000100000100010101
101110101010111010101010101010111011101110111011101
100010101010100010101010101010001000101010001000101
101011101010101110101110101110101110101011101110101
101010001000100010100010100010100010101000100010001
111010111110111011111010111010111010101110111011111
100010000000001000000010000010001010100000001000001
101111111111111111111110111111101011101111111111101
101000000000000000000010000010001000001000001000101
101011111111111011111011111010111111111011101010101
100010000000100010000010001010000010100010100010101
101110111110101110111110111011111010101110111110101
100010000010001000100010001000100010101000100010101
111011111011111011101010101110111010101010111010101
100000100010000010001000100010001000101010000010001
101111101011111011111011101011101111101011111011101
101010001010001000001010001010101000101000101010001
101010111110101111101110111010101010101010101010111
101010100000100000100000100010100010001010100010001
101010101111111110111111101110111111111110111111101
100010100010000010100000000000100000000010100000101
111110111010111010111110111111101011111010101110101
100000100010100010000010100000001010001000101010001
101110101111101111111011101111111010101111101011111
101010100000100000001000001000001000100000100010001
101010111110111110101111111010111111111110111011101
101000100000100000100000100010000010000010001010001
101111101111101111111110101111101010111110101010101
100000001000001000000010101010001000100000101000105
101111111010111011111011101010111110101111111111101
101000001010000010001000000010100010100000000000001
101011101011111110101111111110101010111111111111111
101000101000100000100000100000101000100000000000001
101110101110101111101111101111101111111111111011101
101000100000100010001000001000100000001000100010001
101111101111101110111011111010111111101010101110111
100000100010001000100010001010100000100010100010001
111110111011111010101110101110101011111110111011111
100010001010000010100000100010001000000010001010001
101011101010111110111111111010111111101111101010101
301014001000100010000010000010100000101000001000101
101010111111101010111110111110111010101011111111101
101010100000001000100010101000100010100010000000001
101010111111111111101010101011101110111111111011101
101000000000000000001000100000001000000000000010001
111111111111111111111111111111111111111111111111111

R
