111111111111131111111111111111111111111111111111111
101000100000000000100000100000100010000000000000001
101010111011111110101110111010101010111111111011111
100010001000100010101000100010001010001010000010001
111111101110111010101011101111111011101010111110101
100000101000100010001010001000000010001010000010101
111010101011101011111010111111111110111011111010101
100010101010001010000010000000000010100010001000101
101110101010101110111110111111111010101110101111101
101000101010100000000010000000001000001000100000101
101110101011111011111011111111111111111011111110101
100010101000001010001000100000000000001000100000101
101011101011101110101110101111111111101010101111101
101000001000100000101000100010000000001010100000101
101111111110111111101011111011111011111010111110101
100000001000100000001000001000001000100010000010101
111111101011101111111111101011101110111111111010101
100000001000101010000010001010101000000000001010001
101111111110101010101110111010101111111111101011101
101000000010101000100010101000100000001000100010001
101111101011101111111010101011111011101011111110111
101000001000001000000010100010001000101010000010001
101011111111111011111010111110101110101010101111101
101000000010001000001010000000101000101000100000001
101111111010101011101111111111101111101011111110111
100000000010101010100010000000001000001010100010001
111111111110101010111010111111111011111010101011101
101000001000101000101010101000000010001000101010001
101011101010101110101010101010111110101111101010111
101000101010101010001000101010000010100000001010101
101011101010101011101111101011111010111111111010101
100010001010100000104010100010001000101000001010001
101110111010111011111010101111101111101011101011111
101010000010001010000010101000100000001010101000001
101011111111101010111110101010111110101010101111101
100000001000001010100000101010000010101010000010001
111110111011111010111010101011111010101011111010101
100010100010001010001010000010001000101000100010101
101011101010101111101111111110101111101110111010101
101000001010100000001000100010100000100010001010101
101111111110111111111010101010111110111110101010111
100000000000101000000010001010100000000010101010001
101111111111101011111011111010111111111011101010101
100010000000000010001010100010001000101000001010101
111011111111111110101010101110101010101111111010101
100010000000100000100010101000100010100000000010101
101110111110101111111110101011111110111011111111101
101000101000101010000010001000000010001000100000001
101110101011101010101110111111111111101110111011101
100000100000001000100000000000000000001000000010001
111111111111111111111111111111111111111115111111111

R
