111111111111111111111111111111111111111111111111111
100000001000001000000000100000000000001000001000001
111111101011111010111110101111111110101110101011101
500000101000000010100010101010000000101000101010101
111110101011111110101010101010111111101011101010101
100010101010000000101000100010001000001010101010101
101010101110111111101111111111101011111010101010101
101000100000100000101000000000101010000010001010001
101111111111101011101110111110101010111110111010111
101000000000001010001000100000001000100010000010001
101011111110111010111010111111111111101111111111101
100000100010100010100010100000001000000010000000101
101111101011101010101110101111101111111010111011101
101000101000001010100010100010100000001000100010001
111010101111101110101010111010111111101111101010111
100010001000101000101010100010000000100000101010101
101111111011101011101010101111111011111110101110101
101000000010001000101010100000001000000010100010101
101111101110111110101011111111101110111010101010101
101000100000001000101000001000100000100010101000101
101010111111101011101111101010101111111110101111101
101010000000101010001000101010001000100010100000401
101011111110111010111010101011111010101010111111101
101010001010100010100010100010000010001000100000101
101010101010101110111110111110111111111111101111101
101000101010001010000000101000100010000000001000001
101111101011111011111110101011101011111111101011111
100000101000001000000010101010001010000000001000001
101110101011101011101110101010111010111111101111101
101010100010001000100000001000100010001000101010001
101010111110111111111011111011101111101010101010111
101000100000100000001010001000100000101010000010001
101011101111101111101110101111101110101111111011101
101000101000101000100000100000101010100000001010001
101111101010101011111111111110101010101111101010111
100000001010001010000000000010100010100010101010001
101111111011111010111011111010111010111010101111101
100000100010001010001000001010100010001000100000103
111110101110101011101111101110101111101110111110101
100010001000100010001000100000100010001000100010001
111011111011111110111010111111111110111011101011111
100000001000001000100010001000000000100010001010001
101111111011101011111011101010111111101110111011101
100000001010100010001000100010001000100010100010001
101111101010111110101111111111101011111010101110111
100000101010000000100000000000101000001000100010001
111110101011111010111111111110101011101111111011101
101000101010001010101000100000101010000000100010001
101011101010101110101010101111101010111111101110101
100000100000100000100010000000001010000000000000101
111111111111111111111111111111111111111111111111111

L
