111111111111111111111111111111111111151111111111111
101000100000001000000000001000000010100000000000001
101010101110111011101111101110111010101110111111101
101010001010000010001000100000101010100010100000101
101011111011111110111010111111101010111010101110111
101000100000001000100010001000100010000010001010001
101110101111101011101111101110101111111111101011101
100010001000101000000000100010000000001000100010001
111011101010111011111110111011111111101010111110101
101010101010001010001000001000000010000010100000101
101010101011101110101111111110111011111110101111101
101010001010100000100000000010101000100000001000101
101011101010111111111111111010101110111111111011101
101000101010000010000000001010001010000010000000001
101110101010111010111111101011101011111011101111111
101000101010001010001000001000100000001000100000001
101011111010101011111010111110111111101110111111101
101000000010101000000010100010001000100010000000101
101111111110101111111110101011101010111011111110111
100000001000100010000000101010001010100010000010001
101111111011111011111011101010111010101110101111101
100000001000101000001010001000101010101000101000101
101111101110101111101010111111101010101010101010101
101000100010100000101010001000000010001010101010101
101010111010111110101111101011111011111010111010101
101010000010000000100000001010001000001010001010001
101011111011111110111111111110101111101111101011101
101000101000101000100000100000100000100000001000101
101110101110101011101010101111111110111011111110101
101010100000001000101010101000001000100010000010101
101010111111101110111010101011111011101110111010101
101010000010100010000010001000000010101010100010101
101011111010101111111111111011111110101010101110101
101000001010001000000000001010000000001010100000101
101110101010111011111011101010111111111010111111101
101000101010001010001010001010000010000010100010001
101011101011111010101011111011111011101010111010111
101000101010000010101000100010001000001010100010001
101110101010111110101110101110101011111010101111101
100010101000100000101010001000100010001010100000001
111010101111101111101011111111111110101110111111111
101000101000001000101000000000000000101000100000001
101111101011101010101111101111111111101011101111101
100010001000100010100000001000000000001000001000101
101110111111111110111111111011111111111110111010101
100010100000000000100000100010000000000010001010401
101010111011111111101110101110111111111011101011101
101010100010000010000010100000100000000010001000101
101010101110111010111011111111101111111111111110101
101000001000001000001000000000000000000000000000101
111111111111111111111113111111111111111111111111111

R
