111111111111111111111111111111111111111111111111111
101010000000000010000010000000000010000000000000101
101010111111101010111010101111111010111011111110101
101000100000101000101000100000100010101010000010101
101111101110111011101111111110111110101010111110101
100000001010001010001000001010000010001010000000101
111111111011101010101011101011111011101010111111101
100000001010001000101000100000001000001010100000001
111110101010111111101110101111101111111010111011101
100000100010001000100000101000101000000010000010001
101111111011101010111111101010111011111111111110111
100000001000100010000000101010001000001000000000103
101111101110111111111110111011101011101011111111101
100010101000001000000010001010001000101010000010001
111010101111101110111011101010111111101010111010101
500000100010001000100010101010100010001000101010101
111111111010111011101110101010101010111111101010101
100010000010000010101000101010001000100000001010101
101010111111111110101110101011111111101110101010101
101000100000100000000010100010001000000010101000101
101111101010101111111010111110101011111110101111101
101000001010101000001010001000101000101000100010001
101111111011101011101010111010101110101011111110111
100000100010001010001000100010100010001000000010101
101110101010111010111111101110101111101111111010101
100010101010001010000000000010101000100000101010001
111110101111101011111111111110101010111110101011101
100000100000001000000010000010101010000010001000101
101111111111101111101110111010111010111011101110101
100000001000101000001000101010000010100000101010101
111111101010101011111011101011111010111110101010101
100000101010101000001000101000001010100010100010101
101110101010111011111010101111101110101011101110101
101010001010001010001010100000100010001000001000101
101011101011101010101110101111111011101111111011101
101000101000100010101000100000000000100000100010001
101110101110111110101011111111111110111110101110111
100010101000101000101000000000000010000010100010101
101010101011101011101011111110111011111011111010101
101010001010001000101010000010001010001000000010101
101010111011101110101110111011101010101111111110101
101010001000001000101000101000101000101000000000101
101010111011111011101011101110101111101011111111101
101010100010000010000010000000100010001010001000001
111010101110111110111111111110101110101014101111101
100010101010001000100000100010101000101000100000101
101111101011101111101110101010111011111111111110101
100000001000100000001000101010000010000000100000101
101111111110111111111011101011111110111110101111101
100000000000000000001000001000000000000010000000001
111111111111111111111111111111111111111111111111111

U
