111111111111111311111111111111111111111111111111111
101000100010001000000000000000000010100000100010001
101010101010101111101111111011111010101010101010111
101010001000100000100000101000001010001010101010001
101011111111111110111110101111101010111010101010101
100010000000000010001010100000101010100010001010101
111110111011111011101010101010101011101111111011101
100010101000100010001000101010101000101000100000001
111010101110111110111011101011101110101010111111111
100010001010100000100010001000100010001010000000001
101111101010101111101111101110111011111011111111101
100000001010001000001000100010001000000000000010001
101111111011111011111010111110101111111111101110101
100000100000100010000010001000101000001000101000101
111110101111101111101111101011101011101010101011111
101000101000001000001000001000101010001010001000001
101011101011111011111011111010111011101111111111101
101000100010000010001000001010001000100010000010001
101110111011111010111111101011101110111010111010101
100010001000000010001000001000100010001000101040101
111011101111111111101011111111111011101111101111101
100000100000001000001000100000000010001000000010001
101110111111101011111110101111111010111011111010111
101000100010001000000000100010100010001010000010001
101111101010111011111110111010101111101011111111101
100000001000101000100010100010001000001010000000001
101111111111101110101010101111101011111010111111111
100000000010000000101010001000101000001010100000101
111111111010111111101011111010111111101010111010101
100000001010001000001000000010100000001010100010001
111011101011111011111111111110101111111010101111111
100010101000001000101000000010101000100000001000001
101110101111101110101010111010101010101111111011101
101000001000100010101010100010100010100010000000101
101110111011111010101010111010111010111010111111101
100010001000001000101010001010001010001010001000001
111011101110111111101011101111101111101011101011101
100010000000100000001010101000100000101000101000101
101111111110101011101010101010111110101111101110111
100000100000101000101000101010001010100010000010001
101110111111101110101110101010101010111010111111101
101010001000100010101000101010100010001010001000001
101011101010111010101011101010111011101011101011101
101000100010001010101010100010001000101010001010101
101110111111101010111010111111101111101010111010101
101000100000001010000010100010001000001000101010001
101011101111101011111110101010111011111011101010111
101000100010001000100010001010001010000000001010101
101110111011111110101011111011101011111111111010101
100000001000000000001000000000100000000000000010001
111111111111111111111111111111111111151111111111111

L
