111111111111111111111111111111111311111111111111111
100000000000100010001000000000001000000000100000101
111111111110101010101111111111101011101110101110101
100000000010101000101000001000001010001010001000001
101111111110101111101011101011111010111011111011111
100000100000101000100010001000000010101000000010001
101110101111101010111110111011111110101011111110101
101000101000101010000010001000000010101010000000101
101010101010101011101011101110111110101010111111101
101010100010001010001010001000100000100010100000101
101010111111111010111110111011101111111110101011101
101010100000001010000000100000100000000000101010001
111011101110101011111111111111111111101111101010111
100010001000101000100010000000100000101010001010001
101110111011101110101010111110101110101010111011101
101000101010001000101010001010001000101000100010001
101011101010111011101011101011111011101111101010101
100000001010001000001000101000001010000000001010101
101111111010111111111110101011101011111111111010111
100010001010100000001010001010001000100000100010001
111010101010101011101011111010111110111010101111101
100010100010101000100000001010000010001010000010001
101110111011101110111111101011101011101011111110101
100010001010001010000010001010001010001000100000101
111011101110111011111010111110111010111111101111101
101010100000100000101010001000100010000010001000101
101010111111111010101011101011101111111010111010101
101010000010000010001010101010100010001000100010101
101010111010111111101010101010111011101111101011101
101000101010100000101010000010000000000010001010001
101111101010101110101011111111111111111110111010111
101000000010100010101400000000100000000010101000101
101011111110111010101111111110101111111010101111101
100010000000100010101000000010001000001010100000001
101110111111101110101011111011111010111010101111111
100010001000001000101010001000001010100010100000001
111010101011111011101110101110101010101110101111101
100010101010001000100000100000101010100000100010001
101110101011101110111111111111101110111111111110101
101000101000001000001000000000001000000000000000101
101111101111111011101011111111111011111110111111101
100000100000001000101010000000001000000010100010001
111110101111101110111010101111111011111010101011111
100010100000100010100010100010000000001010101000001
101010101111111010101111111010111111111011101111101
101010101000000010001000001000000010001000000010001
111010111011111110111010101111111010101111111010111
100010100010001000100010100000001010101000001010001
101110101110111011111110111111101110101011101111101
100000001000000000000000100000000000100010000000001
111511111111111111111111111111111111111111111111111

U
