111111111111111115111111111111111111111111111111111
101000001000000000100000001000100000100000000000001
101011101011111010101111101010101110101111111110111
100010101010000010101000101010101000100000100010001
111110101110111110101011101011101011111110101111101
100000100000101000101010001000101010000010101000101
101111111111101011101010111010101010111010101010101
100000000000100010001010100010001010001010001010001
101111111010101110111010111111111011101011101011101
100010001010101000100010100000001000001000001000101
111010101010101011101010101111101011111111111110101
101000101010100010001000101000001000100010001000101
101110111010111110111111101011111110101110101011101
101000100010100010001000001000001000100000101010001
101011101111101011101011111111101011111111101011111
100010100000001010001000001000101000000000001000001
101110111111111010111011101010101111111111101111101
101000000000001000100000101010100000100000101010001
101111111110101111111011101014111110101110101010111
101000100010100010001010001010000010100010000010001
101010101010111010101110111011101110111011111111101
100010001010101010101000101000100000100010000000101
111111111010101010101011101110111111111110111110101
100000001010100000100010100010000010000010001000101
101011111010111011111110101011111010111011101011101
101000001010001010000010001000001000101000101000101
101111101010101110111010111111101111101110101110101
100010101010100000100010000000100000100000101010101
111010101010111111101111111111111011101111101010101
101010100010000000100000000010001000100010001010001
101010111111111111101111111010101010111011101011101
100010000000000000100000001000101010001000001010001
101110111111111110111111101111101011101111111010111
101000001000000000100000101000101000100000000010101
101111101011111111111110101110101110111011111010101
100000001010000000000010100000101010001000001010001
111111111010111110111010111011101011101111101111101
101000000010001000100010100010001000101010001000101
101011111111101011101110101110111011101010111010101
101000000010001000100010000010100000100010000010001
101111111010111110111010111110111110111011111111111
100000000010001000100010001000100000100010000000101
101111111111111011101111101011101110101110111110101
100010000000100010100000101000101000100000100010001
111010111110101110111110101110101111111111101111101
100010100000101000100010100010100000100010000000101
101110101111101010111010111010111110101010111110101
101000101000001010000010001010000010001010101000101
101110101011111011111111101111111010111010101011101
100000100010000000000000000000000010001000001000001
111111111111111111111111111111111111111113111111111

D
