111111111111111111111111111111111111111111131111111
101000000000000000000000000000001000000000100000001
101111101111111111111010111111101111101010111110111
100000100010000000001010000010001000101010100010001
111110111110111111101011111010111010111010101011101
100010100010101000101010000010100010000010001000001
111010101010101010101010111110101011111110111111101
100010001000101010001010001010101010001000100000101
101011111111101011111111101010111010141011101110101
101010000000100010000000001010001010101010001010101
101110101111101111111011111011101010101110111010101
100000101000100010000010001000001000100000100010101
101111101010111010111111101011111111111110101110101
100010101010100010101000001000000000000010001000101
111010101010101110101010111111111111111011111011101
101000100010100000101010000000001000000010000010001
101110111110111111101011111011111011111110111110111
100010100010000000001010001000000010000000100010001
101110111010111111111010101111111110111111101011101
101000100010000000000010100000101000000000101000101
101011101111111111111110101110101011111110101111101
101010000000001000000000101010101000001010100000001
101010111011101011111111101010101111101010111110111
100010001000101000001000001010100000101010000010001
101111111110101111111011111010111010101011111011101
101000001000100000001000100010001010100000100010001
101110101011111111101010101111101010111110101110111
100000100010000000101010100000101010000000101010001
111111111110111110101010111011101011111111101011101
100000000010100010001010001000001000001000001000001
111011111010111011111011101111101111101011101111111
100010000010000010001000100000101000001010001000001
101111111111111010101110111110101111101011111011101
101000000000000010101010000010100000101000100000101
101011111111111110101011101110111110111110101111101
101010000000000010100000101000100010000010000010001
101010111111101010111011101011111011111011101110101
101010000010001010001010001000100010001000101000101
101011111110111010101110111110101110101110101011101
101010000010101010100000100000100010100010101000101
101010111010101011111111101111101010101110111110101
101000101000101010000000101000101000100010000010101
101111101111101010111110101010101111111011111010101
100000000000001010100010001010100010001010000010101
101111111111101010111011111011111011101010111110111
101000001000101010100000100000001000001000100000001
101011101010101010101111101110101111101111111110101
100010001010101010100000101000101000001000000010101
101110111010111010101110101011111011111011111011101
100010000010000000100010001000000000000010000000001
111111111111111111111111111111151111111111111111111

D
