111111111111111111111111111111111111111111111111111
100000100000100000000000001000000000001000100000001
111110101110101111111111101011111110101010101111101
101000100010101000000010101010000010100010101000001
101011111010101111101010101011101110111110101011111
101000000010100000001000100000100010000010101010005
101111111110111110111111111110111011111011101010101
101000100000101000100000001010000010001000001010101
101010101111101011101111101011111011101111111010101
101010100010100010101000101000001000000000001000101
101010111010101110101010101110111110111111101111101
100010001010101000101010100010000000100010000000101
101111101010101010101010111011101111101011111110101
100000100010000010100010001000100010001000000010101
111110111111111111111111101110101110111111111011101
100000100000000000001000001000101000100010001000101
101111101111111111101011111011101011101011101110101
100010001000100000001010001000101000001010000010101
111010101010111111101010111110101111111010111010101
101010100010000000100010100000101000000010100010101
101010111111111110111110101111111011111110111110101
300010100000000010001000101000100010100000000010001
101111101111111011101110101010101110101111111011101
100000001000001000001000101010001000001000101000001
111111111010111111111011101011111111101010101111111
100000000010000000000010001000000000100010001010001
111111111011111010111010111111111110111111101010101
100000001010001010101010000010000010100000001000101
101111101110101110101011111010111010111011111111101
101000100000100000100010001000100010001010000000101
101010111111111011111010101111101111101011101110101
101010001000000010001010100000104000001010001000001
101011101111111110101110111011111111111010111111101
101010100000100000100000101000000000001010000010001
101010111110101111111111101111101111101011111010111
100000100010100000000000100000101000101000100010001
111111101010111111111110111110101110101110101111101
100000001000000000100010000000100010100010001010001
101111111111111110111011111110111010111011111010111
101000001000001000000000100000100010001010001010001
101011101011101111111111101111101110111010101011101
101000101010101000000000101000001000000000100010001
101110101010101011111110101010111111111111111110111
101000101010100010000010001010100000000000000010101
101011101010111110111011111011101111111111111010101
101010101010001000001000001000100010000000001000101
101010101010101111111111101110111010111111101111101
100010101000100000100000100010001010100000100000001
101110101111111110101110111011101011101110101111101
100000100000000000001000000000100000001000001000001
111111111111111111111111111111111111111111111111111

R
