111111111111111111111111111111111111111111111111111
101000000010001000000000100000000000000000100010001
101111101011101011101110111011101111111110101011101
100000001000100010001000001010101000000010101000101
111111111110101110111111101010101011111010101110101
100010000000101010000010101010100010001010101000101
101010111111101011111010101010111110101010101011101
101010100010001000001010001010000010100010001010001
101110101110111111101010111011101010111111111010111
100000100000000000001010001010001010101000000010001
101111101111111111101011101010111110101011111110101
100010001000000000101010001000100000100000000010101
111011111011111110111010111110101111111111111010101
301000001010000010000010100010100000000010100010101
101111101010111011111110111010111111111010101111101
100000101010100000000010100010000000101010000010001
101110101010111111111010101111111110101011111010101
101000100010000000100010100000000010001000100000101
101111111110111110111010111011101111101110111111111
101000000010001010001010001000100000101000100000001
101011111011101011101111101111111011101010101111101
101010001000101000100000100000100010001010101000101
101011101011101010111110111110101110111011101011101
101000001010001010000010000010100010101000100010001
101110111010111011111110111110111010101110111010111
100000100010100000001000100000100010100010000010001
111111101010111111101011101111101110101011111111101
100010001010001000001000001000000000101000100000001
101010111011101011111111111011111111111110101111101
101000100010101000000000100010000000001000101000001
101111101110101110101111101110111111101010101111111
101000001000100010100010001000000010001010100000001
101110111011111011111010111111101010111011111111101
100410100010001000001000100000101010001000001000101
101010101110101111101110101110111011101110101110101
101010101000100000100010001000000010100000100000105
111010101011111010111011111111111110111111111110101
100010001000100010101000000010000010000000001000101
101111111011101110101111111010111011111010111011101
100000000010001010101000000010101010001010000000101
111111101110111010101011111110101010101111111111101
100000100010100010001000000010101000100000001000001
101110111110101111101111111010101111111111101011101
101000000000100000001000001000100000000000100010101
101111111111101111111111101111101111111011111110101
101000000010000000000000000000101000001000100000101
101011111011111111111111101111101011101110101011101
101000101000100000000010001000101010001000101000001
101110101110101111111011111010101110101011101111111
100000000010000000001000000010000000101000000000001
111111111111111111111111111111111111111111111111111

D
