111111111111111111111111111111111111111111111111111
100010100000001000001000000010000000100000001000001
111010101110101110101011101110111110101011101011101
101010101010100000101010100000100010101000101010001
101010101010111111111010111111101010101110101110101
100010000010001000000010000000101000100010100000101
101110111111101011111110111110101111111010111111101
101000001000100010000010001000100000000010000010001
101111111010101110111011101010111111111110111010111
100000000010100010001000101010100010000010001010001
111111111110111011101011101010101010111011101011111
100000001000101000101010001010101000100010101000001
101110111011101110101110111011101111101110101111101
100010000010001000100000100010001000001000000010001
111011111110111011111111101110111011111011111010111
100010000000001010000000001000101000100010001010001
101110111111101011101011111011101110111110101011101
100010001000100000001010001010000010000000101010101
111011101010111111111110101011101011111111101010101
101000101010001000000010101000101000000010101000101
101110101011101011111010101010101111101010101110101
100010100010001010001010101010101000101000100010101
101010111110111011101010101110111010101111111010101
101010000010100010001000100010000010100000001010101
101111111010101110111111111010111110111010111011101
101000000010101000001000001010100010001010000000001
101011111111101011101011101010101011101111111111111
101010000000001000100000101010001000100000000000001
101010111111111111101111101011111110111111111111101
301000100000000000101000001000001000100000100000001
101111101111111110101011111111101011101011101011111
100000000000000010101000001000101010001010001010005
101111101111111010111111101010101010101110111110101
101000101000000010001000101010001010101000100010101
111010111010111111101010101011111011101011101010101
100010000010100000100010001000101010001000101000101
101111111110101110101111111110101010111110101111101
140000100010100010101000100010101010100000100010001
101110101110111010111010101010101010101111111010111
101000100000001010000010001000100000101000000010001
101011101111111011111111111111111110101011111111101
101000101000001000000000100000000010100000100000101
101110101011101111111110101110111011111110101011101
100010101010101000100010100010100000001000001010001
101110111010101010101010111110111111101111111110111
101000100010100010001000100010001000000000000010001
111010101110111111111111101010101111111111111010101
100010100010000000000000101010100000100000100010101
101111111011111011111110101011111110101011101111101
100000000000000010000000001000000000101000000000001
111111111111111111111111111111111111111111111111111

R
