111111111111111111111111111111111311111111111111111
101000000010000000000000100000100000100000000000001
101111111010111111111010111011101010111111111111101
100000001010100000001010000010001010100000000000001
111111101010101011111010111110111010101111111111101
101000001010101000001010100010001010001000001010001
101011111010101111101011101011101011111011101010111
100010001000100010101000001010001000100010101010101
101110101011111010101111111010111110111010101010101
100000101010100010101000001000100010001010000010001
111111101010101110101010111111101011101011111011101
100000101010000000101010000000001010101000100010001
111010101011111111101011101111111010101110101110111
100010101000000010001010100010001000101000100010001
101111101111111010111010111011101110101011111111101
101000001010001010001000001010000010101000000000001
101011111010101011101111101010111110101110111111111
101000100000101000100000001010001000100010000000001
101110101111101110101111111011101011111011111111101
101000101000101000101000000010001010001000100000101
101011111010101011101011111110101010111110101110111
101000000010101010101000001000101010000010100010001
101111111110101010101111101010111010111010111011101
100000001010101010001000001010100010101010000010041
101110101010101010111011111110101110101011111110111
101000100010101010001010000010100010001000100010001
101010111110101011101010111010111011101010111011101
101010100000100010001010101010100010001010100010001
111010101111101111111010101010101111111010101010111
100010101000000000000010100010100000000010001010001
101110101011111111111110101110101111111111111111101
101010101010000000000000101000001000100000000010001
101010101110111111111111101011111010101111111010111
101000100010100000000010001010000010001000001010001
101111111010111111111010111010111111111110101011101
100000001010001000100010100010100000000010101000101
101111101010101010101110111110111111101010111110101
101000100010100010100010000010001000101000100000101
101011111110111110111011111011101010101111101111101
101000000000100010001000001000101010001000001000001
101111111110101111101110111110101011101011111011101
100000100010001000100010000010001000101010100000101
111110101011111010111010101111111010111010101110101
100010001000100010001010101000000010001010000010101
101011111110101111101011101011111111101011111010111
101010001000101000000010001000100000101010001010001
101010101011101111111110111110101110101010101111101
101010101000100000001010000010001010100010100000001
101110101110111111101010111011111010111110111111101
100000100000000000001000001000000000000000100000001
111111111111111111111111151111111111111111111111111

L
