111111111111111111111111111111111111111111111111111
100000100000000000001000001000001000000000000000001
111110111011101111101011101011101011111111111111101
100010001000101000100010100010001010000000100000101
101111101110111010111110111110111010111110101110111
100000100010000010100010001000101000101000100010001
101010111010111110101110101011101011101011111011101
501010001010001000100010100010100000001000001010001
101010111011111011111010111110101111101110111010101
101010100010001000100010100000001000100010001010101
101010101110101110101110111111111010111011101010101
101010100000100010100010001000001010001000101010101
101010111111111010111011101011101011101011101010101
101010001000001000100010001000100010001010001010101
101011111011101111101110111110111110111110111010101
101000001000100000100010100010001010000000100010101
101111101110111110101010101011101011101111101110101
101000100010100010001010001000101010001000001000101
101010101110111011111011111110101010111011111011101
101010101000100010001010000010101000100010001010003
111010101011101010101010101010101111101110101010111
100010001010001000101000101010100010001010100010101
101111111010111110111111101110101010111010111110101
101000000010100010100000100000101000000010000010101
101011111110101011101011111111111110111110111010101
101000100010001000001000001000000010100010001010001
101110101110111111101110101011111411101011111011101
100010100010001000100010101000101000101000000010001
101110101010111010111110101110101110101011111111111
101000101000100010000010100000100010101010000000001
101011111110101111111010111111101110101110111111101
101010000010101000001010001000001000101000001000001
101010111011101011101011101011101011101011111011101
101010101000101000101000001000101010100010000010101
101010101110101110101111111110111010101110111110101
101000100010100000100010000010001010101000100010001
101111101010101111111010111011101010101011111010111
101000001010100010001000001010001010001010000010101
101011111010111010101111111010111011111010111010101
101010001000101010100000001010001000000010001010101
101010101111101010111111101011101111111111101010101
101010101000000010101000101010000010001000001010001
101010101111111110101010101010111110101010111011101
101000100000000000101010001010100000100010100000101
101111111111111111101011111010101111111110111111101
100000001000000000001010000010001000000010000010001
101111111011111011111011101010111011111011111010111
100000001010000010001000101010100000101000001000101
101111101010111110101110111010111110101111101111101
100000100010000000100000000010000000100000000000001
111111111111111111111111111111111111111111111111111

U
