111111111111111111111111111111111111111111111111111
101000101000001000001000001000001000000000001000001
101010101011101010101011101010101010111111101111101
100010100000100010101000100010101010100000101000001
111110101111111110101111111110101011101110101011101
100000101000000000100010001000101010001000100010101
101111101011111111111010101011101010111011111110101
101000101010000000001000100010001010101010001400103
101010111010111110101111111110111010101010101010101
100010000010100000101000001010001010101000101010101
111111111111101111101011101011101010101111101010101
100000000000001000001000100010101010001010001010001
101111101111111011111110111010101011101010111011111
101000100000100000000010100000101000000010101000001
101110111110111111111010101111101011111110101111101
100010000010100000101000100010001010000000100000001
111010111010101110101111111010111110111111101111111
101000101010101000100000000010000000100000101000001
101111101010101011101111111111111111101110101110101
101000000010001010001000100000000000001010100010101
101011111111111010111010101111111111101010111010111
101000001010001010000010101000000000101010101010001
101111101010101011111111101110111011101010101011101
100000101000101010000000100010001000101000001000001
101111101111101010111110111011111110101111111111101
101000001000001000100010000010000000101000100010001
101011111011111111101011111110101111101010101010111
101010100000100000001000000010101000001010101000101
101010101110101111111111101010111011111010101111101
101010101010001000001000001010001000000010001000001
101010101011111111101011111011101111111111111011101
500010100000000000101010000000001000000010000000101
101110111111111110101011111111111010111010111110101
100010001000100010001000000000000010100010100010101
111010101010101011101111111111111110101111101010101
101010100010101000101000100000000000100000101010101
101011111110101010101010101111111111111110101010101
101000000010101010100010100000100000000010001010101
101111111010101011111110111110111111111011111010101
100010000010101000000010101000100010000010001010101
101010111110101111111010101011101010111010101011101
101010100000100000001000001000001010001000101000101
101110101011111110111111111111111010101111111110101
100010101010000000100010000000100010100000000010101
101010101010111111101010111110101110111111111010101
101000101000100000001010101000100010100000001010001
101111111111101111111010101011111010101110101011101
101000000000100000101010100010000010100010101000101
101011111110111110101010101111101110111110101011101
100010000000000000100000100000001000000000101000001
111111111111111111111111111111111111111111111111111

D
