111111111111111111111111111111111111111111111111111
101000000000000000000000100000100000000000000010001
101111111110101011111110101110111110111111111011101
100010000010101010001000101010000000100000100000001
111010111010101110101110101011111111101110101111101
101000101010141000100010001000000000001000101000105
101111101010101011111011111011111110111011101010111
101000100010101000001000100010000010001000001010001
101010101110101111101110101110111011101111111011101
100010100010101000000010100010101010000010001010101
111110111011101011111110111110101011111010101010101
100010001010001010100000100000101000001010100010101
101010111010111010101011101111101111101110111110101
101000100010001010101010001000100000101000100000101
101110101110101010101010111010111010101011101110101
101010101000101000101010100010000010101010000010101
101010101011101110101110101011101111101011111010101
101000101010100010100000101010001000001000001010101
101111101010101010111111111011111011101111101110101
101000001000101010100000001010000010000010101000101
101011111110101110111011101010111111111010101011101
101000001000100000000010100010000000100000101000101
101111101011111111111110111011111110111111101110101
101000001010001000100000100000100010100000001000101
101011111110101010101111101111101010101111111010101
100010000010100010100010001010001010000010000010101
101110101010111110101010111010111011111010111111101
100010101000100000101010100010100000101010001000101
111010101111101111111010111010111110101011101010101
100010100010100010000010001010100010100000101010001
101110111010111011101111101010101010111110101011111
100010001010001000100000100010001010000010001010001
111011111010111110101110101111101011111010111010101
101000001010100000100010001000101000001010100010101
101111101010101111111111101010111111101010101110101
300000100010001010000000101010100010001010101000101
111010111110111010101110111010101010111011101011101
100010001010100000101010001010001000101000100010001
101111101010101111101011101011111111101110111110111
101010000010101000101000000010001000001000100010001
101010111110101010101111111110101111101011101011101
101000100000100010100000101000100000001000001010001
101110101111111110111110101010101111111111111010111
100010101000000010000010100010101000000000000010001
101010101011111011111110111110111011111111111111101
101010100010001000100000100000100010000000000000001
101011111110111110101111101111101111101110111111101
101000000010000010100010100000001000100010001000001
101110111110101110111010101111111010111111101011111
100010000000100000000010000000000010000000001000001
111111111111111111111111111111111111111111111111111

U
