111113111111111111111111111111111111111111111111111
101000000000000010000000100000100000001000001000001
101111111110111010111110101110101111101010111010101
100000000010101400100000100010100010100010100010101
111111111010101111101111111010111010111011101110101
100000001000100000001000100010001010001010001010101
101111111111101111111010101111101011101010111010111
100010000000001010000010100010100010001010000010001
111010111111111010101110111010111110101011101111101
100010001000001000101000000010000000101010001000101
101011101110101011101111111111111011111010111010101
101000100010100010001000000000100010000010100010001
101111111010111110111011111110101110111110101111101
100000001010101000100000001000100000100000101000101
101111101010101011101111111011101111101111101010101
100010001010101000001000001010101000101000001010101
111010111010101111111011101010101011101011111011101
101010000010001000001010001010000010001000100000001
101011111111101111101011101011111110111110111011111
101010000010000000101000101000000000000010001010001
101010111011111110101110101111111111111111101110101
101010001000001000000010100000100000100000100000101
101011101111101111111110111110101110101110101111101
101000001000100000000000100010001000101000100000101
101111111110111111111111111011111011101011111111101
100000000000100000000000000000100010001010000010001
101111111110111110101111111110101110111010111010111
100000000010100000101000000010100000101000101010001
101111111010101111111011111010111111101111101010101
101000001010001000100010001010001000000000000010101
101111101011111010101110101011111011111111111111101
101000001000000010001000101000001010000000100000101
101011101111111111111010111111101011111010111010101
100010101000001000000010100000001000100010100010101
111110101110111011101110101111111110101110101110101
100000101000100010100010101000000010101000101000001
101011101011101110111010101011101010101110101111101
101000001000001000100010100010001010100010100010001
101111111011111110101011111010111010111010111010111
100000100010000000101010001010100010000010000010101
111110101111101011101010101110101111111111111110101
100000100000001010001010100000101000100010001000101
101111111111101110111010111011111010101010101011101
101000000000101000100010001010000010001000100010001
101111111110101011111111101110111111111111111110111
100010000010001000100000001000100000001000000010001
111010111010111110101111101011111011101110111010101
100010101010100000100000101000001000100010001010101
101110101011101110111110111111101110111011101011101
100000100000001000000010000000000000100000001000001
111111111111111111111111111111111115111111111111111

R
