151111111111111111111111111111111111111111111111111
101000000000000000000000100000000000000000000010001
101111111111111111101110111011111011111111111010101
100010001000000010001010001010000010000000001010101
111010101011111010111011101010111110111111101011101
101000101000001000100000101010100010100010101010001
101111101011101111111110101110101110101010101010111
100010001000100010000010100000100000101000101010001
111010111111111010111010111111101111101111101010101
100010000000000010101010000010001010000010001010101
101011111111111110101010111010111010111010111010101
101000100010100000101010100010001000100010000010101
101110101010101011101010101111101111101011111111101
101000001000101010001010101000001000101000100000101
101111111011101010101010111011111010101110101110101
100010000010001010101010001010000010101000101010101
101010111110111010111010101011101110101110101010101
101010001000001010001010101000001010100010001010101
101011101011111011101011101111111010111011111010101
101010001010100010001000000010000010001000100010101
101011101010101110111111111010111111101010101110101
101000101000101000000000001000100010001010101000101
101110111110101110111111101011101010111110101011101
100010001000100010000010001010001010000000101000001
111011101011111011111110111010111011111111101111101
100010001010001010000010100010101000000000000000101
101110111011101010111010101110101011111110111111101
101010000000001000001010000010101010000010100000101
101011111111101111111010111110101010111011101110101
100010100010001000100010001000101010001000001000101
111010101010111110101111101011101011101111111011101
100000101010000000100010101010001000001000001000001
111111101011111111111010101010101111111011101111111
100000001000100000100010001000101000000010000010001
101111111110101110101110111111101110111011111010111
101000100010001000100010100000100010001000100010001
101011101011111011111010101110111011111110101110101
101000101000001010000010101010041000100010101010101
101010101011111010111111101011101110101010101010101
101010001000001000100000001010001000101000101000101
101111111111101110101111111010111011101111101110101
100000001000100000101000000010001010001000100010101
101111101010111111101110111111101010101010111011101
101000100010000000100010000000100010101010001010001
101011111111111110111011111110111111101011111010111
101000000000000010001000100000100000001010001010001
101111111010111011101110101110101110111010101011101
101000001010101010100010001000100010101000100010001
101011101110101010101111111011111110101011111110101
100010000000100000100000000000000000100000000000101
111111131111111111111111111111111111111111111111111

D
