111111111111111111111111111111111111111111111111111
101000001010000010001000000000001000000000100000001
101110101010111010101011111110111011111010101110101
101000100010001010100010000010000010000010101000101
101011101111101010111110101111111110111111101011111
101000101000001000100000101000000010000000101000001
101110111011111111111011101011111010111110101111101
100010001000100000000010001010001010000010100010001
111010101110101110111110111010101011111110111010111
101010100010100010100010001010101010000010001010001
101010101110111110101111101010101010111010111011101
100010100010000000101000001000101000100010100000101
101110111011111111101011111111101111101110101111101
100010001000000010000010000000001000101000001000001
111011111010111110111110111111111011101011111011101
101000001010000000100000101000001000001010001010001
101111101011111111101111101011101011111010101010111
100000101000100010001000001000100010001010100010103
101110101110101110111011101110111110101010111110101
100010101000001000100010100010000010101010001010001
111010101111111011101110111011111010101111101011101
100010100000001010001000001010000010100000001000101
101111111111101010101111101010111110111111111011101
100010000000001010101000100010100000100000001010001
111010111111111011101010101110111010101111101010111
100010001000000010001010100010001010101000000010001
101111101011111110111010111111101110101111111111101
100000001000101000000010000000100010101000100010001
101111111110101011111111111110111010101010101010111
101000000000100000000000100000101000100010101000101
101111111011111111111110101110101111111010101111101
100000100010000000100000101010100010001010101000001
111110101111101110111111101010101010101010101111101
100010101000101010100000001000001000101010100000001
101110101010101010101111111111111111101010111111101
501000101010001000001000004000100000101010000010001
101011101011111011111011111110101111101111111010111
101000001000101000100010100000101000100010000010101
101111111110101110101110101111101010111010111110101
100000000000100000101000101000000010000010000010001
101111111111111110101010101110111110111111111011101
100000100000000010101010100010100010000000000010101
101110101111111011101011111010101011111111111010101
101000100010001000101000001010101000100010001000101
111010111011101110101011101011101110101010101011101
100010101000001010001000101000100010001010100010001
101110101111101011111111101110111011111010111110111
101000001000101000000010000010001010000010000010101
101111111010101111101010111011101010111111111110101
100000000010000000001000100000100010000000000000001
111111111111111111111111111111111111111111111111111

L
