111111111111111111111111111111111111111111111111111
301000001000000010000000000010000000100000100000001
101110101010111010111111111010111110101110101110101
101000101010101010100000100010101000100010001010101
101011101110101011101110101110101011111011111010101
101000100000101000101000100000001000000000001010101
101110111111101110101110111111111111111111101010111
100000100000000010100010100000100000001010000010001
111111101111111010111010101110101111101010111111101
100000101000100010000010101010101000101000100000001
111010101010101111111110101010101011101011101111101
100010100010100000000010001010001000001010001000101
101110101111111011111111111011111011111110111010101
101000101000000010000040000010000010000000101010101
101011111011111110111111111010111110101111101010101
101000000010000010100000001000100010101000000010001
101111101110111010101011101111101010101111111111101
101000101000100010101000100000001010100000100000101
101010111011101110111110101111111011111110101110101
101010001010101000100010101000001000000000101010101
101011101010101011101010111011101110111111101010101
101010100010101000001010100010101000100010000010101
101010111110101111111010101110101111101010111110101
101000100000100000001010000000101000001000100000101
101110101110111111101011111110101011111111101111101
100000101000001000101000100010100010000010001000001
101111111011101110101110101110111110101010111110111
100010000010100000100000100010000010101010000010101
111010101110111110111111111011111011101011111010101
100010101000000000100000000010001000101000001010101
101111101011111111101011111010101110101111101010101
100000101000000010001000100000101000101000101010001
111110101111111010111110111011111011101011101011101
100010100010000010100010001010000000001010001010001
101010111011111110111011101110111111111010111011101
101010001000000000001000100000101000100000001000101
101111101111111111101010111111101010111110111110111
101000001000000000101010000000001010000010100010001
101011111011111110101111111011111011111010101011101
101010000010001000100010000010001010001010101000001
101011111010111011111010111010101011101011101111101
101000001010000010001010001010101000101010001000101
101111101010111111101010101110101110101010101010111
100000100010100000100010101000100010101010101010005
101110111110111010111011101011111010101010111011101
101000100010100010001000001000001010100010000000101
101111101010101111101111111111101010101111111110101
101000001000100000100010000010001010100000100010101
101011111111111110111010111010111010111110101011101
100000000000000000100000100000100000100000001000001
111111111111111111111111111111111111111111111111111

L
