111111111115111111111111111111111111111111111111111
101000000010000000100000000000000000100000000000001
101111111010111010101111111011111110101111111111101
100000001000001010100010001000001000001000101000101
111111101011111010111110101111101111111010101010101
100000101010000010100000101000100000001010101010001
101111101110111110101111101010111111101010101011111
101000100000100010100010001010000000100010101010001
101010111111101010101010111011111110111110101010111
101010100000101000101010000010000010000000101010001
101010101110101111111011111110101111111111101011101
100010001010001000000010000010100000000010001010001
101111111011111011111110111110111110111010101010101
101000000010100010000010100010100000100010101000101
101011111010101010111010101010101111101110101111101
101000100010001010100010001000100010101000100010001
101110101111101010101111111011111010101110111110111
100010100000101000100000001010001010101000100000101
111010111110111011111111101010101010101010101111101
101000100010001010000010001000101010000010100010001
101111101011101011101010111111101011111111111010101
100000001000101000001010000010001000100000001010101
101011111111101111111111111010111110101110111011101
101000100000001000001000000010100010001010001000001
101110101111111011101011111110101011111011101111101
100010100010001010100010100000101000000010000000101
111010111010101010111110101111111110111010111111101
101010000010100010001000001000100000100010000000001
101011111110111111101011111010101111101111101111111
100010000010001000101010001010001000101000101000001
101110111010101010101010101011111010111010111011101
101000101010100010100010101000100010100010001000101
101011101011101110101110101010101110101111101110101
100010001000100010101000101010100010001000100000101
111110111110101110101011101110111011111011111111101
100000000010101000100010000000001010000010000000001
101111101110111011101111111111111010111010111111111
101000100000100010001000001000000000100010000000001
101010111111101111111011101011111111111110111111101
100010101000100010000010100000100000000010100010001
111110101010101010111110111111101111111010111010111
101000101010001010100000001010001000100010001010001
101011101011111010101111101010111011101111101011101
101000100000001000001000000010001010001000100010101
101110111111101111111111101111101010111010111010101
100010001000001010001000101040101010101010000000101
101111101111101010101010111010101010101011111111101
100000001000100010101010000010101010100010001000001
101111111010111110101011111110101010111110101011101
100000000010000000100010000000001000000000100010001
111111111111111111111111111111111111111311111111111

L
