111111111111111111111111111111111111111111111111111
101000000000100000000000000000100000001000000000001
101110111110111111111011101111101011111011111110111
100000100010000010001000100000001000100010000010001
111111101111111010101111111111111110101110101111101
100000001000000010100010001000000010101000100010001
101011111011111110111010101011111010101011111010101
101010000010001000101000101010001010001010001010101
101010111110101010101111101010101010111110101010101
101000100000101010101000101010101010000000101010101
101111111011101110101010101010111011111111101010111
101010000010100000100010101010001000001000101010001
101010101110111111101110101010101111101110101011101
101000101010000000101000100010100000100010000000103
101011101010111010101010111111101110111011101111101
101000101010001010101010100000001000101000101000101
101110101011101011101011101011111011101110111010101
100010101000101000101000001000101000001010001010001
111011101010101110101111111110101111101011101011101
101000101010001010001000100000100010001000100010101
101110101011111011111010101111101110111110111110101
100010001010000010000010001000000000100000000010001
111011111011111010101111111111111011111011111010111
100010001000001010101000000000001010000010001010101
101110101111101010111011111110101010111110101010101
101000100000101010000010000010101010001000101010001
101011111110101011111110111011101011101011101111101
100000100010101000001000100000001000101010101000101
101111101010101110101011101111111110101010101010101
101010001000101000101000101000100000001010101010101
101010111011101011111110111010111111111010101010101
100010100010001010000010000010000000100010101010101
111110111110111010111010111111111110101110101010101
100010001000100010100010000000000010101000100010101
101011101011111010111011111111111110101110111110101
101000001000000010001010000000000000100010100000101
101011111111101111101010101111111110111010101111141
101010000000101000001000101000100000001000100010001
101110111011101011111111111010111111111011111010111
100000001010001010001000000010100000000010000010101
101111111010111010101011111110101111111110111010101
101000100010101000101010001010101000001000100010001
101010101110101111101010101010101110101010111111101
500010100010101000001010100010001000101010100000001
111110111010101011101010111011111011111011101111111
101000101000101010001010101000001000001000100000101
101011101111101011111010101111101011101110111110101
101000000000001010001000100010001000101000000010001
101111111111101010101111101110111111101011111111101
100000000000001000100000000000000000001000000000001
111111111111111111111111111111111111111111111111111

D
