111111111111111111111111111111111111111111111111111
101000000010000000000000100010000000001000000000101
101111101110111111101110101010111110101011111010101
100000100010001010001010101000001010101010001010101
111110101011101010111010111111101010101010101010101
100010101000101010100010001000100010101010101010001
101010111011101010101111101010111110101110101011101
101010001000000010100000100010000000100000100010101
101111101011111110111011111111111111111111111110101
100000001010000010001000000000100000100000000010101
101111111010111010101111111010101010111110111010101
100010000010100010100010001010101010001000100010101
111010111110111011101010101010101011101011111010101
100010001010001000101000101010101000100010001000101
101111101011101110101111101010101110111110101111101
101010000000101010100000101010101010001000100000001
101010111111101010111011101010101011101011111111111
101000001000001010001010001010101000100010000000041
101110111011111011101110111011101110111111111010101
100010100010100000100010001000100010000000001010101
111010101110101110111010101010111010111011101010101
101010101000001010001010101010100010001000101010103
101010101011111011101011101010101111111110101010101
101010101000000000100000101010001000001000101010101
101010101111101111111110101111101011101011101010101
101010100010001000100010001000100010100010001010101
101011101011111010101011111010111110111110111110101
101000101000100010001000000010000010000010100000101
101110101110101111111111111111101010111010101111101
100010101010101000001000001000101010001010001000001
101110101010101110101010111010111010101111111011111
101000100010100000100010100010001010100000001000101
101011111010111111101111101111101010111110101110101
101010000010000000101000001010001010100010101000101
101010111111101110101011111010111010101010111011101
500010000000100010101010000010100010101010001010001
101111111110111010101010101110101111101010101011101
101000100010101010101010101000100000001010101000101
101011101010101011101011101011111111111011101110101
101000001000101000001000101000000000100010000010001
101011111111101111111110101111111110101110111111101
101000100000000000101000100000000000001000100000001
101110101111111110101010111111111111111110101111111
101000001000100000001010100000000000100000101000001
101111111010101111111011101111111110111011101011101
101000101010101000001000000000000010001010001010001
101010101010101011101111111011111111101010111010101
101010100010001010001000001010001000101000100010101
101010111111111010111011101110101010101011111110101
100010000000000010000010000000100010001000000000101
111111111111111111111111111111111111111111111111111

L
