111111111111111111111111111111111111111111111111111
101000000000100010100000001000001000000010000010001
101111101110101010101110101110101011111010111010111
100000100010001010001000100010100010000010100010001
111110111011111010111011111010111110111110101111101
100010001000001010100010000010100010100000100000001
101011101111101010101110111110101010101011111111111
301000100010001010100010100000101010101000000000001
111010111010111010111010111110101010101111111011101
100010100010101010001010100000101000101000001000101
101110101110101011101010101111101111111011101111101
101010100000100010001010100000100000000010100010001
101010111111101111111010111110111111111110111010101
101000100000001000000010000000100000001000001000101
101011101111111011111111111111101011111010111111101
101000100000100010001000000000101000001010000000105
101111111110101010101011111110111011101011111110101
101000001000101000100000100010001000100010000010001
101011101011101111111111101011101110111110111111111
101000100010100000001000001000001000100010000000001
101110111110111011111011111111111011101011111111101
100010100000000010000010000000101010001000000000101
101010101111111110111111101110101010111111111110101
101010101000100000100000100010001000100010000010001
101110101010101110101110111011101111101011111011101
100010101010001000100010001000100000001000000000101
101010101011111011111011101010111111111111111111101
101000101010001000001010001010000000000000000010001
101111101010101111101010111110111111111111111010111
101010001000101000001010000410001000000000001000101
101010111111101111111011111011101111101111101111101
101010100000100000001010001000100000101000000010001
101010111110111111101011101110111110111011111011101
101000000000000010100010000010100000100010001000101
101111111111111010111110111010111011101110101110101
100000001000000000001000101010001000001000101010001
111111101110111111101010101011101111111011101011101
100000100010100000101010100000100010000010000010001
101111111011101110101010111110111010101111111010111
101000001000001000101010001000001010101000100010001
101011101111111011101111101111101010101010111111101
101010100000100010001000101000101010100010000000001
101010101110101110111010101010111010111111111111111
100000101000100010100010100010100010100000001000001
101111101111111010101110111110101110111010111011101
101000001000100010001000000010101000001010000000101
101011111010101111111111111010101111101111111110101
101010000010101000000000001000100000100000100010101
101010111110101110111111101111111110111110101011101
101000000010000000100000000000000000100000001000001
111111111111111111111111111111111111111111111111111

L
