111111111111111111111111111111111111111111151111111
100010100000000000001000000000100000000010000000001
111010101111101011101110111110111111101010111111101
100010001000101000100000100010000000001000100010001
101111111010111110111111101111111111111111101110111
100000001010000010001000001000000000000000001000101
111111101011111010101011101011111111101111111011101
101000001010001010101010001000000000101000001010001
101011111010101010101110111111111011101011101011101
101010001010100010100010000000001010001000101000001
101010101010111110111010111111101010111011101111101
100010101010100000101010001000001010100010001000101
101110101010101111101011101011111010101110111010101
101000100010100000001000101000000010000010000010101
101011111110111111111110111111111111101111111010101
100010000010100000100010000000001000101000001010101
111111111010101110101011101111101010111011101010101
100000001010001000101000100000100010100010101010001
101111101011111011101110111011111010101110101111111
101000000000101000001010001010001010001000100000001
101111111110101111111011101110101011111110111111101
101000000010001000000000101000101000000000100000001
101011111010111011101111101011101111111110101111101
101010001010100010101000001010101000000010101000101
101010111010101110101011111010101011111010101010101
101000100010100000101010000010001010000010100010101
101011101011111011101011111010111010111110111110101
101010001010000010001000100010101010000010000010101
101010111010111110111110101110101011111011111010111
100010001010100010000010101010100000001000000010001
101111101110101011111010101010111111111111111110101
100010100000001000100010101010100000001000000010101
111010111111111111101010101010101111101011111011101
101010000010001000001010101010001000100010001000101
101010111110101011111010101011111110111110101110101
101000100010100010001010001000000000001000101000101
101110101010111110101011111011111011101011111011101
100000101000100010100010000010001010000010000010001
111111101111101011111110111110101011111110111110101
100010001000001000001000100010101000000000100000101
101010111011111111101011101010101111111111101111101
101010100010100010001010001010100010001000100010001
101010101110101010101011101010111010101010111010111
101000100000101000101010001010001000100010000010101
101111111110101111111010111011101111111111111110101
100000001010100010001010100010001010000000000010001
101110101010111010101010111010111010111011111111101
100010100010001000100014001010001000101000000000001
111010111111101111111111101011101011101111111111111
100010000000000000000000001000001000000000000000001
111113111111111111111111111111111111111111111111111

U
