111111111111111111111111111111111111111111111111111
100010000000001000001000000010000010000010000000005
111010111111111010101011111010101010111010111111101
100010100000000010100010000010101000100010100000101
101110101111111110111110111110101111101110101110101
100010100010001010100000100000101010001000101000101
111010111010101010101111101111101010111110101011101
100010001000101010101000001000001010000000101000101
101110111111101010111011111011111011111110101110111
101000100000101010100010100010001000000000101010001
101011101110101010101110101110111011111111101011101
101010001010101010000000101010001010100000100010101
101010111010101011111111101010101010101110111010101
101010000010100000100000001000100010101010040000101
101011111010111110101111101111111010101011111111101
101010000010000010100010001000001010100000100000001
101010111111111010111010111011101010111110101111101
101000001000001000101010001010001000100000101000001
101111111011101011101011111010111011101111101111111
100000100010001000001010001010001010001000100000001
111110101110111011111010101011101110111011111111101
100000100010100010000010100010100000100000000000101
101111101010111110111110111110111111111110111011101
100010001010100000100010001000100000000010100010001
111011111010101111101011101010101111111010111110101
100010000010101000001000101010001000001000100010101
101110111110101011111011101011111011101111101010111
101000100010100000101000000010001010100010001010001
101110111010111110101111111110101010111010111011101
301000100010001010101000100000100010100010101000001
101011101111101010101010101111111110101110101111101
101000100010001010100010101010000000100000101000001
101010101010111010111010101010111011111111101011111
101010101000100000001010101010001000001000001010001
101010111011111111101110101011101110101011101010101
101010001000000010101000101000101010101000101000101
101111101111111010101011101010101010111011101111101
101000101000001010100010001010001010001010000000101
101010101011101010111010111111101011101010111111101
101010001000101010100010100000100000101010000000001
101011111110101010101110101110111111101011111111111
100010000000101010000010001010100000100010000000001
111110101111101011111111101010101110101111111011101
101000100010001000000000100010000010100000000010001
101011111010111111111110111110111110111111111110111
101010100010100000000010000010001000100010000010001
101010101111101011111011111011111011101110101111101
101000100000001010000010001010000010100010100010001
101110111111111011111110101010111110101010111010111
100000000000001000000000100000100000001000001000001
111111111111111111111111111111111111111111111111111

L
