111111111111111111111111111111111111111111111111111
101000000000101000001000000000001010001000000000101
101111101110101011101011111011101010101011111010101
100000101000100010100010000010000010100010100010101
111110101110111010111110111111111110111110101110101
100010140010001010001010000000000000100000101000101
111010101011101010101011111111111111111010101110101
300010101010101000100000100000100000001010100010101
101110101010101111111110111010101110101011111010101
100000101010000000001010000010101000101000100010001
101111101011111111101011111110111011101110101111101
100010001000001000101000100010100010000010101000101
111011111111101010101010101010101111111010101010111
100010000000001010001010001000001000100010101010001
101110111111111011111011111111111010101110101011101
100000100010001010001010000000000010101000100010001
111111101110101010101110111111111110101010111110101
100000100000101010100000100010001000100010100000101
101011101111101010111111111010101011111110101111111
101010000010001010001000001000101010000010101000001
101010111110101011101010101111101010101110101011101
101010001000101000101010101000001010101000100000101
101011101011101110101110101011101011101011111111101
101000101010001010001000100010001010001010001000001
111010101010111011111011111111111010111010101011101
100010101010001000000010000000000010000000101010001
101111101011101111111010111111111110111111111010111
100000001010100000000010001000000000101000000010105
101111111010111111111011101110111111101011111110101
101000101010000010001010100010000000001000001010101
101010101010111010111010111010111111111111101010101
100010001010001010100000100010100000000010001000101
111111101011101010101111101110101111111010111011101
101000001000101000100010001000101010001000101010001
101011111110101111101110111011101010101111101010101
100010000010100000001000100010001000100000000010101
101111101110111111101011111110111111111111111010101
101000001000100000101000000010000010000010001000101
101110111010101110101111111010111010111010101111111
101000100010101000100000100010100010101000101000001
101010101111101011111110101110101110101111101011101
101010100000001010000010101000100000000000100000101
101011111111111011111010101110111111111011111011101
101010000000000010000010100010000010001010001010001
101010111111111110111110111010111110101110101110111
101010100010001000000000100010100000101000100010001
101010101010101111101111101110101111101011111011101
100010001010101000101000100010100000100010001010001
111011111010101010111010111011111110111110101010101
100000001000100010000010000000000000100000100000101
111111111111111111111111111111111111111111111111111

U
