111111111111111311111111111111111111111111111111111
100010000010100000001000001000000010000000100000001
111010111010101110111010111010111110101110111110101
101000100010001010040010001010000000101010100010101
101111101110111011111110101011111111101010101011101
100000101000000000100010101010000000101010001010001
101011101011111111101010101010111110101011111010101
101010001000100000001010101000100010101000001000101
101110111111101111111011101011101011101011101111101
100010000010001000001000100010001010001000100000101
101011111010111011111110111110111010101111101111101
101000001010100000000000100000100000101000101000001
111111101010101111111111101111111111101010101011111
100000001000100000000010001000001000001010100000001
101111111111111111111011101011101011111010111111101
101000000010000000001000101000101000001010001000101
101011111010111111101110101110101111111011101010111
100010001010000010001010100010100000001000101010001
101110101011111010101010101110111111101110101011101
101000101000000010100010101000101000100000101010001
101011111011111110111010101011101010111111101010101
100010001010000000101010100010001010001000001010101
111010101110111111101010101110101011101011111010101
100010100000101000000010101010100010101000000010101
101110111111101011111110101010111110101111111110111
101000100000001000001000101000000000100000000010001
101011101111101111101011101011111110111011111111101
101000100000101000001010101000100010100010000000001
101110101110101011111010101111101011101010111111101
101010100010101010000010000000001000001010100000101
101010111110111010111111111111111111111110101111101
100010100010000010001000000000000000000000100000001
111010101010111111101011111111101111111111101111111
100010001010001000001000100000001000000010101000101
101111111011111011111010111011111011111010101010101
100000001000000010001010001000100010100010100010001
111111101111111111101011101110101110101110111111101
100010001000001000001000100010100000100010000000101
101010111110111010101011111010111011111010111011101
101010001000100010101010000010001010000010001000101
101011101010101110111010101111111010111111111110101
101000001010101010000010101000000010100000100000101
101111111011101011111110111011111110111010101110101
100000001010001000000010000000001000100010001010101
111111101010111010111011111111111011101111111010101
100000101000001010100000000010000010000000001000101
101010101111101110111111111010111110111111101111101
101010100000100000100010000010001010100000100000001
101011111110111111101011111111101010111110111111111
101000000000000000001000000000001000000000000000001
111111111111111511111111111111111111111111111111111

R
