111511111111111111111111111111111111111111111111111
101000000010000010001000000000000010000000001000001
101011101010111010101110111111111110111110101011101
101010001000100000100000100000100000100000100010101
101010111111111111101111101110101111101111111110101
101010000000000010001000001000101000101000000010001
101111111011111011111011111010101010101111111010111
100000001010001000001000101010100010100010000010001
111111101011101111101110101011111110111010111111101
101000001000100000101000101000001000001010000000001
101011111110111010101011101111101011111010111110111
100010000010000010100000100000100010100010100010001
101111101011111110111110111110111110101111101011101
100000101010000000100010000010000000100000101010001
111110101011111111101011111011111110111110101011101
100010101000000000001000101010000000100010001000101
101010101111111111111110101010101111101011111110101
101010001010000000001000101000101000101000001000101
101111111010111111101011101111101010101111101011101
100000000010000000100010001000001010100010001010001
101111101011111110111110111011111010101010111011101
101000001010000010100000000010000010101010001000101
111011111010101110111011111110111110111011101110101
100010000010100010001000100010000010001000100000101
101110111110111011101111101010111011101010111111101
100010001000100000101000001010001000101010101000001
101011111011101111101011111011111010101110101011111
101000001000101000101000101000001010100010101010001
101111101110101010101010101111101010111010101010101
100010001000100010001010100000101010100010100010101
111010101011111111111010111110101110101110111010101
100010101000100000000010100000101000101000001000101
101110101110111111111110101111101011101110101111111
101010100010001000001000100000001000100010100000001
101010111111101011101011101111111110111011111111101
101010000000001010000010100010000000101000000000101
101011111111111011111110111011111011101111111110101
100010000000100000001000001000000010001000100000101
111010111111101111101011111111111110101010101111101
101010000000000000101010000000000010101010001000001
101011111111111111101010111110111010111011111110101
101000100000100000001010100010001010100010000000101
101110101110101111111010101111101010101111111011101
100010001000100010000010001000001000101000000010101
101011111011111010101110111011111110101110111110101
101010000010001010100000100010000000100000101000101
111010111110101010111111101110111110111111101010101
100010001000101010001000100010100010001000001010001
101111101011101011101010111011101011111011101011111
100000000010000010000010001000001000000000100400001
111111111111111111111111111111131111111111111111111

U
