111111111111111111111111111111111111111111111111111
101000100000000010000000100000000010000000100000001
101010101111101011111010101110111010111110101110111
100010100000101010000010100010100010000010001010001
111110111110101010111110111010111011111111101011101
101000100000101000100010100010001000001000100010101
101011111111101111101010101111101111101010111010101
101000000010001000001010100010001000000010100000101
101111111010111111101010111110101111111110101111101
300000001000100010001010000010101000100000100010001
111011101111101010111111111010111010101111111110101
100010001000001000100000000010000010100000100000101
101110111011111011101111111111101110111110101111111
101010100000100010001010000000100010100010100000001
101010111110101110111010111010111110101110111111101
101000000000101000100000100010001000100010000000101
101111111011111011111111101111101011111011111110101
101000100010000010000000001000100010000000000010101
101010111110111110111111111011111110111111111010101
101010000000100000100000100000000000001000101010101
101011111111101011101110101111111111101010101010101
101000101000001000001000100000000000100010100010101
101110101011111111111011111111111110111110111110101
100000100010001000100010000000100010000010100000101
101111111110101010101110111110111011111010101111101
100010000010101010001000100010000000101010100010001
111010111010101011111011111011111110101010111011101
100010101010100010001000001000000010101010001010001
101110101010111111101011101011101110101011101010101
101000100010100000101000101010001000101000100010101
101110101110101110101110101011111011101110111110101
101000100010001000101000101000000000001010100000101
101011111010111011101011101011111111101010111010101
101010001010001010001010101010000010000010001010101
101010101011111010111010101110111011111111101010111
101000101000000010001000100000101000000000101010001
101111101111111111101110111111101111111110101111101
100000100010000000100000000000001000100010101000001
111110101010111110111111111111101010101110101011101
101000101000000010000010001000100010100010001010101
101011111111111111101010101010111110111011111010101
100010001000001000101010100010000000001000000010001
101110101011101010111011111111111111101110101011111
101000100010100010001000000000001000100010101010005
101010111110111111101011111111101010111011101110101
101010100000000000101010000000100010101000100000101
101010111011111111101110111110111110101110101111101
101010001010000000100010000014000010100010101000001
101111101010111110111011111011111010101010111011101
100000001000000010000000000010000000101000000010001
111111111111111111111111111111111111111111111111111

R
