111111111111111111111111111111111111111111111111111
101000000000100000100000000010000000100000001000101
101011101110111010111110111011101110101110101010101
101010100010000010100000100010001000101000100010101
101010111011111110101111101110111110111010111110101
101000001000001000001000100010000010001010100010001
101111111011101111111110111011111011101011101011101
100000001010100000100000001000100010101000001010001
111111101010111110111011101110101110101011111011101
100010001000001000100010001000101000101000001000101
101010111111101011101111111011101110101111111110101
101010100010001010100010001010000010100000100000101
101010101110111010101010101011111010111110101111101
101000100000101010101000100010000010001000101000101
101111111011101010101111111110111111101011101110101
100000001000101010101000001000100000001010001000101
111111101110101010101011111010111010111011101011101
101000001000001010101000000010001010001000101000101
101011111111111010101111111110101111101110101010101
101000000000000010100000000010100010000010001010001
101111111111111110111111111010111010111111111011111
101000000000100000000010001010101010000000001000101
101010111110101011111010101010101010111110111110101
101010100010101010000010101010001010000010000010101
101010111010101011111110101011111011111011111010101
104010001000101000100000101000001000100000100010101
101111101011101110101111101111101110101111101110101
101000101000100010001010000010100000100010001000101
101010101011111011111010111010111111111110101011101
301010101010000010000010001010000000000000101010001
101011101110111111111011101010111111111011111010101
101000100010100000000000101000101000000010001010101
101110111010111110111011101111101011111110101011101
100000101010000000100010001000001000101000101000101
111110101011111110111110111011111110101011101110101
100010101000001000100010100000000010001010100000101
101010101011111011101010111110111011101010111111101
101000101000000010101010000010001010001010100000101
101111101111111110101011111011101010111010101010101
100010000010000000101000100010001000100010001010105
111010111110111011101110101011111111101110111010101
100010000010001000100010001010001000001010100010001
101110111010111110111011111010101011111010101111101
100010001000100000001010001010101000001000101000001
111011101111101111101010101110101111101110101011111
100010001000001010001000100010100000100010101010001
101111111011111010111111111010101111111010101010101
100000000010100000100000001010100000100010101010101
111111111110101111111111101010111110101111101010101
100000000000000000000000001000000010000000001000101
111111111111111111111111111111111111111111111111111

R
