111111111111111111111111111111111111111111111111111
300000100000000000000010000000000010000000001000001
111110111111111011101011111111101010111011101110111
100010000010001010101000000000001010001010000010001
111011111010101010101111111110111110111011111010101
100000001000101010101000100010100000100010001010101
101111111111101010101010101010101111101110101011101
100010001000001010100010101000101000100010101010001
101010101011111010111110111111101010111010101010101
101000101000001000100010000010000010100010101010101
101111101111101111101010111010111111101110101010101
100000100000100010001010101000100000101000101000101
111110111110111010111010101111101110101011101111101
100000000010001010101010001010001000100010101000101
101111111111101010101011101010111011111010101011101
100010000000001010101010101010001000001000101010001
111010111110111010101010101011101111101111101010111
101010100000100010101010100000101000100000001010001
101010111111101110101010111110101110101111111011101
100010001000001000100010000000100010001000001000001
101111101011111011101111111011111010111011101111101
100010001010000010000000001010000010001000100000101
101110111010111111111111101110111111111011111110101
101000100010100000100010001000100010000010000000101
101010101110101110101010111010101010111110111111111
101010100010101010001010100010101010001000100000001
101011111010101011111010111010101011101010101111101
101000001010000010000010001010101000101010101000101
101110111411111010111111101011101010101011101010101
100010001000001010100010101010001010101000001010001
111111101111101110101010101010111010101111111011101
100000100000100000101000101000101010100000100010001
101110111110111111101111101110101011101111101110111
100010100000000000100000100010001010001000100010005
111010101111111110111110111011101010111010111011111
100010001000001010001000001000101000100010001000001
101111111011101011101011101110101111101111101011101
100000000010001010001010100010100000100010001000101
101111111110111010111010111010111111101010111011101
100010001000100000100010100010001000101010001010001
111011101011101111101110101111101010111011101010101
101000101000100000001000001000100010000010001010101
101110101110101111111111101010111111111110111010111
100010000010101000000000100010001000000000101010001
101011111010111011111110111111101011111111101011101
101000100010000010000000100000101000000000100010001
101010101111111110111111101110111111111110111110101
101010101000100000100010001010000000100010001000101
101011101010101111101010111011101111101011101011101
101000000010100000001000000000100000001000000010001
111111111111111111111111111111111111111111111111111

D
