111111111111111111111111151111111111111111111111111
100010000000000010000010000010000000100000100010001
111010111011111110111010111010101110101110101011101
100010001000000000001010001010100010100010001000101
101111111011111111101011101010111010101011111110101
100000001010000010001000001000001010101010000010101
111111101110111011111011111111111010111010111010101
100000101000101010001000000000100010000010001010101
101011101011101010101111111110101111111111101010101
101000100010001000100010001000100000001000001010001
111110111110101111111011101011111111101011111011101
100000100000100000101000100010001010001010001000001
101110101011111110101110101110101010111010101111111
100010101010001000100010100000100010101010101000001
101010111010101011101110111111111010101010111011101
101010000010101000100010000000001010100010000000101
101011111110101110111011111111101010101110111111101
101000100010100010000000000000101010100010101000001
101110101110101011111110111111101110111010101011111
100010100010101000000010100000101000100010001010001
111010111010101111111110101110101011101111101010101
100010001000101000000000101010001010101010001010101
111111101011101011111111101011111010101010111010101
100010001000100000100000100010000010101010001000101
101010111011111111101110111010111110101011101111101
101000100010000000001000001010000010001000100010001
101111101110111111111011101011101010111110111010111
101000100010000010100010101000101010100010000010001
101011111011111010101110101110101010101011111111101
101000000010001010100010001010101010101010000010001
101111101110101010111011101010111010101010111010111
100000101000100000001000101010001010101000101010001
101110111011111110111110101011101010101111101011101
100010100000100010100000101000100010001000001000101
111110101111101010101111101110111111111010101110101
100010001000101010100000100010100010000010100010001
101011111010101011111110111010101010111114101111101
101000100010001000001000100010101000100010101000001
101110101111111111101011101110101111101010111011111
100010001000000000000010100000100000101010100010001
101011111110111111111110101111111110101010101111101
101010000010001000001000001000000010001010100010001
101010111011111011101111111010101111111010111010101
101000100010001010001000100010101000001010001010101
101111101110101010111010101110101010111010111010101
101010001000100010000010001000101010100010001000101
101010101011111111111111111011111010101111101111101
100010101010001000000000001010001010100000100010001
111010111010101111111111101010101010111110111010111
100010000000100000000000001000100010000000001000001
111111111111111111111111111113111111111111111111111

D
