111111111111111111111111111111111111111111111111111
100000100000101000000000001000000000100010001000001
111110101110101011111011101011111110101010101110101
100010001000100010000010001010001000101000101000101
111011111011111110111110111010101011101111101011111
100010001000001000100010000010101010000000101000001
101010101111101011101111111110101011111110101111101
101000100000101010100000001000101000000000100000101
101110111111101010101111101011101111111111111110101
100010100000001010101000100000100000001000100000101
101011101111111010101010111111111011101110101111101
101000001000000010101010000010000010100010101000001
101111111011101110101011111010111110111010101010111
100010001000101000001000001010100000000000101010001
111010101111101011111111101010101111111110101011101
101000101000001000000000001010101000000010101010001
101111101011111111111111111010111011111011101010101
100000100010000000000000001010001000101000101010101
101110111110101111111111101011101110101110101110101
101000100000101000100010001010000010100010101000103
101011101110111010101011101010111110101010101011111
101000001010001010101000101010000000101010001000001
101111111011101010101110111011111111101111111011101
100000100010001010001010000010000010000000000010001
111110101010101011111011111110111110111110111110101
100010001010101010000010000000000010100010000010101
101011111010111010101011111111101010101011111010111
501000000010100010101000001000101010101000100010001
101111111110101111101111101010111010101110111111101
100000100000100000001000100010001000101000100000101
111110101110111111111010111111101111101011101110101
100000101010100010100010000000100000101010001010101
101111101010101010101111111010111110101011101010101
101000101010001010000010000010001000101000101000101
101010101011111011111110111111111011101110101011101
101010001000100010000000100000001000100010101010001
111010111110101110111011101111101110101010141011101
100010100010000000101010001010000010101010101000101
101111101011111111101010111010111110101010101110101
101000001010000000101010000010000000101010101000001
101011111010111110101011111011111111101010101111101
101000001000100010100000100010000000101010100010101
101111101111111010111110101111101110111010111010101
101000100000000010001000101000001010000010001010001
101010111111111011101011101011111011111111101010111
100010000000001000101010001010000010000000100010001
101111101111111110101110111011111010111110111111101
100000100000001000100010001000001000100010100000101
111110111111101011111011101111101011101010101110101
100000000000100000001000000000001000001010000010001
111111111111111111111111111111111111111111111111111

D
