111111111111111111111111111111111111111111111111111
100010001000000000100000100000000000000000000000001
111010101010111011101010101111111011111111111111101
101010101010100010001010100010001000100010001000001
101010101010111110111010111010101110101010101110111
101010101010001000001010001010100010101000100010101
101010101011101011111011101010111110101111111010101
101010100010001010001010001010100010001000000010001
101011111110111010101010111010101011101011111111101
100010000010100010100010001000101000101010000000101
101110111010101110111111101110101110111010101110101
100000100010000010001000100010101010100010101000101
111111101111111011101011111011101010101111101111101
104000101000001010001000001000001000001000001000001
101110101110101010111110101111101111111010111011111
300010100000101010000010100000001000001010001000101
111110111111101110111011101111111011101011101110101
100000100000100010001000101000000010001010000010001
101110101011111011111010101011111110111010111111101
101000001010001010001010101010000010001010000000001
101111101110101010101110111010111011101011111110111
101000101000100010100000100010001010001010000010001
101010101011111110111011101111101110111010111011111
100010101010000000101010001000101000100010101000001
101110101010111111101010111010101011101110101111101
100010101010000010000010001010001010000010000000101
111010111010111010111111101011101011111111111110101
100010100010100010100000100010001010000000001000101
101110101110101011101110111110111010111111101011101
101000100010101010001010000010101010100010100010001
111010111011101010111010111110101010101010111110111
100010100010001010100010000000101010001000100010001
101111101110111110101011111111101011111011101010101
100000100010000010101000100000001010000010001010101
101110111010111010101110101110111010111110111011101
101000100010001000001000100010100010000010100010001
111010101111101111111110111110101111101110101110111
100010101000001000100010000000100000101000100010001
101111101111111010101011111011111011101011111010101
101000001000000010001000100010001010001010001010101
101011111011111111111110111110101010111010111010101
100010000000000000000010000000101000100010100010101
101110111110111111111011111111101111101110101110101
101000100010001000000010100000101000100010100010101
101111101011101011111110101011101010111010111010101
100000101000101000101000001000100010000010001010105
111110101110111110101011111110111111111110101010101
100010100010000000100010000010000010000000101010101
101010111011111111101111111011101110101111111011101
101000000010000000000000000000100000100000000000001
111111111111111111111111111111111111111111111111111

R
