111111111111111111111111111111111111111111111111111
300010000010000000000010000010000010001000000010001
111010111010111111101010111010111010101010111011101
101000101010000010101010101000101000100010101010001
101111101011111010101110101111101111101110101010101
100000001000001000100010000010001000101000100000101
101011111111101110111011111010101010111011111111101
101000100000001000100000100010101010001000001000001
111110101111111011101111101110101011101011101011111
100000101000001000100000000010101010001010001010001
101110101011101111111011111010101011101110111010101
100010101000100010001010001010101000100000101000101
101011101010111010101110101010111110111111101111101
101000101010100000100000101000100010100010000000101
101110101110111111111111101110101010101011111011101
100010100010000010000010000010101000101000001010001
111110111011111010111011111010101111101111101010111
100010001040001010101000100010100000000000101000105
101010101111101010101110101110111111111011101011101
101000101000101010000010100010000010001010001010001
101111101010101011101110111011111110101110111011101
101000001010001010001000100010000000101000100010001
101011111011111010111011101110111111101011101110101
101000100010000010001010000010100000101000100010101
101110101110111111101011111010111010101010111010111
100010101000100000101000100000100010101010100010001
101011101011101110101110111111101111101110101110101
101000001010001000101010001000000000000000100010101
101111111010111011101011101011111111111111111010101
100000001000001010001000101000001000000000001010101
111111101110111010111010101111101011111111101011101
100000100010100010100010100010101000000010001010001
111011111011101110111010111010101110111110111010101
100010001000100000000010100010000010100010100010101
101010101110101111111111101011111110101010111010101
101010100010101000000010001010000000101010001000101
101110111010111011111010111110111111101010101111101
100000100010000010001010000000100000001010100010001
111111101011111110101010111111101111111011111010111
100000001000100010100010001000100010001000000010001
101111111110111010111110111010111010111111111111101
100010000000000010000010100010001010100000000000001
111010111111111111111011101111101010101111111111111
100010000010000000001000001000101010000010000000001
101111111110111011111111111110101011111010101111101
100000000010101000000000000000101000001010101000101
101111111010101111101111101111101011101010101011101
100000101000100010101000101000001010001010101010001
111110101111101010101010111011111110111011101010111
100000000000001000100010000000000000100000001000001
111111111111111111111111111111111111111111111111111

R
