111111111111111111111111111111111111111111111111111
101010000000001000001000000000000000000000000010001
101010111110101010101110101011111110111111111010101
101000100000101010100010101010001010100000100010101
101110101111101110111011101010101010101110101110111
100010101000000000100010001010101000101010101000001
111011101111111111101110111110101111101010101011101
101000100000000010001000100000100000000010101000101
101110101111111010111011101111111111111110101111101
100000100010000010100000000000000010100010100000101
101111111110111110111011111011111010101010111110101
100010000010001000001010001010001010101010100010001
111010111010101111101110101010101010101010101011101
101000101010100000100000101010101000101010001000101
101111101010111110111111101110101111101011111010111
100010001010100010100000101000100000001000001010001
101010101011101010111011101011111111111111101111101
101000101000001010001010001010000000100000001000001
101111101111111011101010111010111110101111111011101
101000001000100010001000100010100010000000000010005
101110111110101110111110111011101011111111111110111
100010100000101010000010001000101000001000100010101
101010111010101010111011101110101111101110101010101
301010001010101000101000100000101000101000101010001
111011101011101011101110111011101010101011101011101
100010100010001000000010100010001010101000101000101
101110111010111110111110101110111110101110101011101
101000100010000010100000101000100000100010001000101
101010101111111010101111111011101111111011111110101
101010000000100010100000100010000000100010000010001
101111111111101111111110101111101110101010111011111
100000100000001000000010100000100010101010001000001
111110101111111011111010111110111110101110111111101
100000101000000010100010000000000010100000100000001
101011101011111110101111111111111010111111101111101
101010001000001000100010001000001000100000001000101
101110111011101011111010101011101011101111111011101
100010100010001010000010100010101010001000001000001
111010111110111010111110111110101110101011101111111
100010100010001000100000100010101000101000100000001
101110101011101011111110101010101011101110111111101
100010101000001010000010001010101000101000100010001
101010101111111011101011111010101010111011101110101
101010001010000010001000000010001010001010001000101
101011111010111110111111111110111011101010101011101
101000100010001000100000001010001000100010101010001
101110101011101110101111101011101011111010101011111
101010001000100000101000100000101010001000101000001
101011111110111111101010111111101110101111111111101
100000000010000000400010000000000000100000000000001
111111111111111111111111111111111111111111111111111

R
