111111111111111111111111111111111111111111111111111
301000000000100000000010000000100000000010000000001
101110111111101110111011111010111110101110101111101
100010000000000010001000000010000010101000101000001
111010111111111110101111111111111010111011101110111
100010000010000010101000001010000010000000140010101
101111101110111010101110101010111111111111111010101
101000001000101010100010100010000000000000001010101
101110111011101011111010111011111111111111101010101
100010001010001000100010100000100000100000100010101
111011101010101110101110111111101010111110111110101
101010001010100010001000000010001010001000100010101
101011101011101011111011111010111011101011101010101
101000101000101010001000001010001010001000001010001
101110101110111010101110111011101010111111111011101
101000101010001010100000100010001010000000000010001
101011101011101010111111101110111011111110111110111
101010000010001000100000101000101000000010100000101
101011111110111011101110101011101111111010101111101
101000100000100010001000100010000000101010100010001
101110101111101110101011111111101110101011111010101
100010001000100010101000000000001010101000001000101
101011111010111011101111111111111010101111101111101
101000101010001010001000000010000010001000100010001
101110101010101010111011101010111011101010111010111
101000001010101010001000101010001000001010001000101
101111101010101011101111101011101111111011111111101
100010001010101000100000101000100000100000000000005
111011111010101110101110101110111110101111111110101
100010001010100010101000101000100000101000100010101
101010101010101110101011101111101111101011101010101
101010100010101000101010001000101000000010001010101
101110111110101011101010111010101111111110111010101
100000101000101010001010000010000000000010001010101
101111101011101010111011111111111111111011101010101
100000001000101010101000100000000000100010001000101
111111101110101010101110101111111110101110111111101
100000101000101010000010000000100010100010001000001
101110101011111011111111111110101010111011101111101
100010101000001000000000100010101010001000100000101
111010101111101111111110101110101111101110101110101
100010100000100000100000100000001000100010101000101
101110111110111110101111101111111010111010101011101
101010000010100010001010001000000010100010101010001
101011111010101111111010111011111110101110111010111
100010001000100000000000001010000000101010000010101
111011101111111011111111111010111111101011111110101
101010000010001010000010000010000010001000000010101
101010111010101110111010111111111011101011111110101
100000100000100000100000100000000000001000000000001
111111111111111111111111111111111111111111111111111

U
