111111111111111111111111111111111111111111111111111
100010000000000000100000000000100000100000001000001
111010101111101111101110111110111010101111111011101
100010101000001000101000100010001010100000001000101
101111101110111010101011101111101010111110101011101
100000100010001010001000101000001010000010100010001
111110111011111011111110101011111011111011111110101
100010001000000010000000100010000010000010001000101
101111101111111110111111101110101110111110101011111
100000100000000000100000101000100010001000101010001
101110111111111111111110101011111011101011101010101
100010000000000000000000101000001010101010001000101
111110111111111111111011101111111010101010111111101
100000100000000010000010001000001010101010000000001
101111111111111010111110111011101010101011111111101
100000000000001000100000100010000010000010001000101
101111111111101011101111101011111111111110101010101
100010001000101010100010101000000000100000101010101
111011101010101010111010101111111110101111101010101
101000101010001000001010101010001000101000101010001
101110101011101111111010101010101011101110101111111
100010101000101000000010101000101000100000100010001
101110101110111011111110101111101110111011111010101
101000100010000010000000101000001000100010401000101
101011101111111110111111101011101010101110101111101
500010000000000000000010001000101010101000101000001
101110111111111110111010111110111010101011101011101
101000000010000010001000100000100010101000100010001
101110111110111011101111111010101111101110111110111
100010100000101000100000000010100000000010100000001
111010101111101110111111111110111111111110111111101
101010101000001010001000001000100010000010000000101
101011101011101011101011101011101010111010111110101
100010001000100010001010100000101000100010001010101
101110111110111110111010111111101111101111101010101
101000100010100000101000001000100000100000101010101
101011101010101111101110111010111110111110101010101
101010001000101000100010100010000000100000101010103
101010111011101010111010101111111111101111101010101
100010001010001010001000101010000000100010001010101
111110101010111011101111101010111110111010111010101
100010101010100010000000001000101000100010000010101
101011101010111011111111111011101010101110111110101
101000001010001000001000000010001010101010100000101
101111111111101111101011111111101010101010101111101
100010001000001000001010000000001010101000100010101
101010101011111011111010101111101011101111111010101
101000100010000010000010101000101000100000100010001
101111111111101110111111101010101110111110101110111
100000000000001000000000001010000010000000001000001
111111111111111111111111111111111111111111111111111

L
