111111111111111111111311111111111111111111111111111
100010001000000010001000000000100000001000000000001
111010111011111010101010111110111011101011101111101
100010100010001000100010100010000010001000100010001
101110101110101011111110111011111110111111111011101
100010000010101000000010001000001010000010001000101
111010111110101111111011101110101011111010101110111
100010100000101000001000101000100000101010100010001
101111101111101110111011101011111110101010111011101
100000101000100010001010001000100010101010001000001
111110101110111011101010111110111010101011101111101
100000100010001000100010000010001000001000001000001
101111111010101110111011111010101111111111111011111
101000000010100010001000100010100010000000100010001
101111101110111011101110101110111010101111101110101
101000001004001010001010101010101000100000101000101
101011111011101110111010101010101111111110101011101
100010000010100010100000101000100000000010001010001
111110111110111010111110101110111111111011111011101
100010100000101010000010100010100000000010000000101
111010101110101011111010111010101111111110111110101
100010001010101000001010001010100000000010000010101
101111111010101111101011111010101111111011111010111
100000000010100000101000000010101000101000100010001
111011111110111010101111111110101010101010101111101
100010000010001010100000000010101010001010101000101
101110111011101110111111101110101011111010101011101
100010101000100000001000100010100010000010101000101
101010101011111111101110111010111010111110101110101
101010101000000000100000100010001010000010101000101
101010101111111010111110101111101011111010101011101
101010001000001010100010100000101010100010101010001
101011101011101011101010111110101010101111101010111
101000001010001000101000100010001010100000100010001
101111111010111110101111101011111010111110101111101
101000100010000000100000101000100010000010101000001
101110101110111111111110101110101111111010101011101
101000101000100000001000101000101000000010001000101
101011101011101110111011101011101011111011111110101
101000101000101010100010001000001010001010100000101
101110101011101010101110111111111010111010101111111
100000101010001010001000000000100010000000100000001
111011101110111011111111111110111011111011111111101
101010001000100000000000000010000010001010000000001
101010111011111110111111111011101110101110111111101
101010000010000000101000000010001000101000100010001
101011111110111111101011111111111011101011101010111
100010000010001000001000001000100010001000101000101
101110111011101011111111101010101110111110101111101
100000100000001000000000000010001000000000100000001
111111111111111111111111111111111111111115111111111

L
