111111111111111111111111111111111111111111111111111
101000000000001000001000000010000000100000001000101
101111111110111011101011101110111011101011101010101
101000000010100010101010100010001000001000100010101
101011111010101110101010111011101111111110111110101
101010000010100000100010001010001000100000100010001
101010111110111110111111101010111011101111101011101
100010101000000000100000101000100010001000101010001
111110101011111111101110101111101110101010101010111
100000100000000000001000000000001000101010101000101
101111111111111111111111111111101011111010101111101
100000000010000010000000100010001000000010100000001
111111111010111010111110101110111111111110101111101
100010001010100000100000100000100000000010101000101
101010101010111111111110101111111011111010111010101
101000100010001000000010100000000010000010000010101
101111111111101011111010111111111110111111111110101
100010000000101000101010000000001000000000100000101
111010101110101110101011111111101111111110101011111
101010100010100000101000100000100000101000101010001
101011111010111011101110101110111110101011101110101
101010000010001010000010100010100010100000100000101
101010111111101010111110111010101010111111101111101
100010100000101000100010001010101010000000100010005
101110111010101111101011101011101011111110111110101
301000001010101000001000001000101000001010100000101
141110101011101011111111111010101110101010101111101
100010101000101000001000000010001000101010001000001
111011101110101111101011111111111011101011111011111
101010001000100000101000100010000010001000001000101
101010111010111110101110101010111110111111101110101
101000100010100000101000101000100010100000000010001
101111101111101111101011101111101010101111111011101
100000100000101000001000101000001010101000000000101
111011101110101011111111101011111010101011111111101
100010001000101000000000100010001010001000000010001
101110111011101111111010101110101011111011111110111
100000101010001000001010101000101010000010000000101
101111101010111011101110101010111010111110111111101
100000001010000010100000101010100010100000100000101
111111101011111110111111101010101111101111101110101
100000101000000010000000101010100000001000001010001
101110111111111010111011101011111111111111101011101
101000001000000010001010001000000010000000001000001
101111101011111111101010111010111010111111111111111
100010000010000000001010001010101010000000000000001
101011111110111111111011101110101011111011111111101
101000000010000010000000100010100010001000000010001
101111111011111010111111111010101110101111111110101
100000001000000010000000000000100000100000000000101
111111111111111111111111111111111111111111111111111

D
