111111111111111111111111111111111111111111111115111
101000001010000000000000000010000010000010000000101
101011101010101111111111111010101011101011101110101
100010101010101010000010100010101000101000001010101
111110101010101010101010101111101110101111111010101
100000101000101000101000100000001010100010001000101
101011101111101011101111111111111010111010101011101
101000100010001010001000000000000010001000101000101
101110111010111110111011101111111011101111101110101
101000101010000010001000100000001010100010001010001
111010101011111010101110111111101010111010111011101
100010001000000010100000100000101000100010001000101
101110111111111110111111101110101111101110101011101
100010100000000010000010000010101000100010101000001
101011101011111111111011111110101010111011101111111
101000001010001000001010000000100010000010001000001
101111111010101011101010111110111111111110101011101
101010000010101010101000100010100000001000101010101
101010111110101010101111101110111011101011111010101
101010000010100000100010000010001010101000100000101
101011111010111111101011111011101010101010101111101
101000001000000010001000000010001010001010001000101
101011101111111110111111111010111010111111101010101
101000100000100000100000100010000010100000101010001
101011111010101111101110101111111110101010111011101
101010001010100010000010101000001000101010000010001
101110101010111011111010101111101011111011111111101
100000101010001010001010100000001010000010000000101
111111101110101010101011101111111010101110111110111
101000100010101000101000001000100010101000100010001
101010111010101111101110111010101110101011111011101
101010100010101000100010100010001010100000001000101
101010101110111010111010101111111010111111101110101
100010101010000010001010101000000000101000100000101
111110101010111111101011101011111111101010111111101
100010101000000010001000101010000010001010001000001
101010101111101110101110101010111110101011101011101
101000100010001000100010101010100000101010001010101
101111111010111011111010101010101111101011101010101
101000001010001010100010001010001010001000100010001
101011101010111010101111111010111010111110111110111
100010100010100410001010000010000010000010001000101
101110111110101110111010111111111110111011101011101
101000100010100010101000000000000010100010101000101
101010101011111010101011111111111011101010101110101
100010101000000010100010001000100000001000101000101
111110101111111110111110101010111111101111101011101
100000101000000010000000101010001000001000101000101
101111101011111111111111101011101111111010101110101
100000001000000000000000000010000000000010001000001
111311111111111111111111111111111111111111111111111

U
