111111111111111111111111111111111111111111111111111
101000100000001000001000100010000000100000100000101
101110101011101011101011101010111010101110101110101
100010001000100010100010001000100010001000101010101
111010111110111110111010111111101111111011101010101
100010001010100010000010000010101000001000001000101
101111101010101010111111111010101011101111111011101
101000101010101010100010001000100010100010001010003
101010101010101010101010101110111110111010101011101
101010000010001010101000100010100000001010101000101
101111111011111011101111101110111011111011101110101
100000101000101010000000100000000010001000100010001
111110101110101010111111111111111110101110101111101
100000100000001000100000000000001000100000100000001
101111111111101111101111111111101011111111101111111
101000000010101000001010001000100010000010001000001
101011111010101011111010101010101110111010111111101
101000101010001000100010100010101000001010000000101
101110101011101110111010111110101011111011111110101
100010101000101010001000100010001000100010001010101
111010101110101011101011101011111110101110101010101
501000101000100010001010001010000000101000100010001
101111101011111010111110111010111111101011111111101
100000001000001010000010001010000000101000000000101
101111101111101011111011101011111011101011111011101
100000100000101000101000001400000010001000001000101
111110111110101110101111111111111110111111101110101
100010100010001000100000000000100000100000101010001
101110111011111110111111111011101111101110101011111
100010100000000010001000000010001000001010100010001
111010101111111011101011111110111011111010111010101
100010001000001010101000100000100010100000101010101
101111111011101010101110101111101110101111101011101
101000001000101010000000101010000010000000001010001
101010101010111011111111101010111011111111101010101
100010101010001000100000001010001010000000101010101
101110101011101110101111111011101010111110111010101
101000101010000010100010001000101000100010000010101
101011101110111110111010101010101111101111111110101
101010000000100000100010100010101000100000000000101
101011111110101111101110111111101011101111111011111
101000100010101000001000000000001000000010001000001
101110101011101011111011111111111111111011101111101
101010101000001000001000000000100000101000101000101
101010101111111110101111111110101110101110101010101
100010100010000010101010000000100010100010001010101
111010111011101011101010111111111010101111101010101
100010001000101010001010001000001010100000001010001
101110111110101010111011101110101010111111111011101
100010000000001000100000000000100010000000000010001
111111111111111111111111111111111111111111111111111

R
