111111111111111111111111111111111111111111111111111
100000100000001000001000000010000000000000000000001
111110111110101011101011101010111111101111111111101
100010001000100010001010001010000000101000000010001
101011101011111110111110111011111111101011101010111
101000101010000010100000101000100010001000101010101
111110101010111010111011101110101010111110101110101
100000100010001010001000100010001010000010100010101
101111111110101111101010111011111010111011111010101
101000001000100000101010001000100010001000001010001
101010111011111110101011101010101111101111101011101
101010000010000000101010001010001000101000101000101
101011111110111110101110111011111011101010101110101
100010000000100000101000101010000010001010100010001
101110111110111111101011101010111110111011111011111
100010100000100000100010001010000010000010000010001
111010111111101114111110101010111010111110111110101
100010000010001010000010100010001000100000100000101
101111111010111011101010111111101111101110101111101
101000001000100000101010001000101000101000101000001
101111101111111110101111101010101010101111101011101
100000001000000000100010001010000010100010001010001
111111101011111111101010111111111110111010111010111
101000001000001000101010000000100010101010001010001
101011111111101010101011111110101110101011101011111
101010000000001010101000001000100000001010001000001
101010111111101010111111101011111111111010111111101
301000101000001010100000001010000010001000001000101
101111101011111010101111101010111010101111101010101
101000000000101010001010001000101010100010001010001
101011111110101011111010111111101010111011111011101
101000100010001010001000100000001000101000001000101
101110101011111010101011101111101111101111101110101
100000101000000010100000100010001000100000100000101
101111101111111110111111111010111010101011111111101
100000100000001010000010001010000010001000000000101
111111111011101011111010101011111111111111111110101
100000001000101000000010101010000000001000001010001
101111101111101011111110101010101111101011101011111
101000100000001010100010101010101010001000100000101
101010111111111010101010101010101010111110111110101
100010001000000000101000100010101000100000100000101
101111101111111111101111111111101011101011101111101
101000101000000010001000000000001000101010001000001
101010101011111010111111101110111110101010111010111
100010101010001010001000101000101000101010101010001
111110101011101011101010111011101011111010101011101
100000100010001000100010000010001000000010100010005
101111111110101110111111111110101111111110111110101
100000000000100010000000000000100000000000000000101
111111111111111111111111111111111111111111111111111

D
