111111111111111111111111111111111111111111111511111
100010000000001000001000000000001000000000100000101
111011111110101011101010111011111011101110111010101
100010000000100010101010100010001000100010100010101
101110111111111110101110101110101110111010101110101
100010100000000000001000101000100000100010001010001
111010101111111111111011101011111111101111111011101
101010100000000000000010001010000000001000000000101
101010111111111111111111111010111111111011111010101
100010100000000000000010001010100000001010000010101
101110101111111111111010101010101111101110111011101
101000101000000000001000100010101000100010100010001
101110101110111111111111111010101010111010111110111
101000101000100000001000001010001010000010000010101
101011101011101111101011101011111011111111111010101
101000101010001010001010001000001000000010000010001
101010101010111010111011101111111011111010111011101
101010101010001010100000100000001010001010100010001
101010101011101010111110111111101011101010111110111
101010100000101000100000100000101010001010000000001
101010111110101011101111101011101010111011111111111
101010000000101010001000101010001010001000000000001
101111111111101010111110101010111010101111111111101
100000100000101010000010101000100010100000000000101
111110101110101010111010101111111011101110111111101
100010100010001010101010001000001000001000100000001
101110101011111010101010111110101111111110101111111
100010101010000010101010000000100000000010100000001
101010111010111110101011111111111111111011111011101
101010100010001000101010000000000000100010001010001
101010101111101011101010111110111110101110101010101
101000100000101000001010001010001000100000101010101
101111111110101111111011101011101111111111101110101
101000100000100000000010100000100000000000101000101
101010101111111111111110111110111110101111101011101
100010001000000010001000000010000010101000001010001
111111111011111010101011111011101110101011111010111
100010001010001010100010001010001000101010000010101
101010101011101010111110101010111011101010111110101
101000101000001000100000100010100010001010000010001
101111101111101111101111101110101111111010111011111
101000100010001010001000101000100000001010001000001
101010111010111010111011101011111111101011101111101
101010100010100010100010001010000000101000100000101
101110101110101010111010111010111110101110111111101
100010100010001010001000101010101000000010000000001
111010111011111011101011101010101011111111111111101
100010001000100010001000001010100000100000001000401
101110101011101110111111111010111111101011111011111
100000101000000010000000000010000000001000000000001
111111111111111111131111111111111111111111111111111

R
