111111111111111111111111111111111111111111111111111
100010100000001000000010000010000000100000000000001
111010101011101110111010111010101110111011111110101
100010001000100010100000101010101010001010100010101
101111101110111010101111101011101011101010101011101
101000100010101010101000100000001010001000101000001
101010111010101010111010101111111010111111101111101
101010100010101010100010100010001000001000001000001
101010111110101010101110111010101111101011111011111
101010001000101010100010101010100010100010001010001
101011101011101010101110101010111010111110101011101
100010100010000010001000100010100010000000101000001
111110111110111110111011101110101110101111101111101
100000000010000010001000101000101010100010000000101
101110111111111010111110111011101010111010111111101
100010001000100010100010000010001010101010100000001
101111101010101110101010111110111010101011101111111
101000001010100010101010000010100010001010001000101
101011111010111011101011111010101011101010111010101
101000100010001000001010000010101000101000100010001
101110101111101111111011101110101110101111101011111
101010001000100000001000100010100010101000101000001
101011111010111110111110101110111010101110101111101
100010001010001000100000101000101010100010001000101
111010101011111010101111101011101010111010111010101
100000100010000010101000001010100010001010001010001
111111111010111110101111111010101110101011111011101
100000001010100010100000000010101000101000000010101
101111101110101110111111111110101011101111111110101
101000100000100010100010001000001000101000100000103
101010111111101010101010101011111110111010101110101
100010001000101000001000101010000010100010001000101
101111101010111111111011111010111010101111111010101
101000101010000000001014000010001010001000100010101
101010101011111111101110111111101011111010101110101
100010101010000000100000100000001000100010101000101
111110101010111011111111101110111110101111101011101
500010101010001000000000100010001000101000101010001
101110101010111110111110111011101011101010101010111
100000100010100000100010001010001010001010001010101
101111111110101111111011101110111010101011111010101
100000001000100000001000001000100000101000100010101
111111101111111011101011111011111111101110111110101
100000101000001010101000100000001000101010001000101
101110101011101010101110101111101010101011101011101
101000100010101000101010101000001010101010001000001
101111111110101111101010111011111010101010111111101
101000000000100000101010001010000010101010001000101
101010111111111110101011101010111110101011101010101
100010000000000000001000000010000010000000100010001
111111111111111111111111111111111111111111111111111

D
