111111111111111111111111111111111111111111111111111
100010100000000010001000001000000010000000000000001
111010101011111010101110101010111011101111111110111
101010101000100000100000101010001000101000000010001
101010101110111111111111101111101110111011111011101
100010001000100010001000100000001010000010001010001
101110111011101010101011111111111011111110111010101
100010101000001010101000000000100000000000100010101
111010101111111010101011111110101011111111101110111
300010001000000010101000100010001000000000100010001
101111101011111010101111101011111111111110111011101
100000101000001010100010001000001000000000001000001
111110111011101010111010111111101011111011111111101
100010001000101010101000000000101000100010000000105
111011101011101110101111111111101010111010111011101
100010101010001000100010000000001010001010101000001
101010101110111011111010111110111111101110101111111
101010100010000010000010001000100010001000100000001
101010111011111010111011101011101010101011111011101
101000001000001010100000101010001010101010001010001
101111111111101010101111101110111010111010101011101
101000000000101000101000100000001010000000101000101
101011111110101111101010111111101011111111101110101
100010000010100000101010000000101010000000100010101
111110111010111110101011111110101010111110111010111
100000100000100010101010001000101000100010100010001
101111111110101110101010111011101111111010111011101
100000001000101000101010100010000000000010001000101
111111101011101011111010101111111111101111101110101
100000101000101000000010100000000010001000001010001
101110101110101111111110111111111010111011111011101
101010100010000000100000000000001010100010000010001
101010111011111110101111111110111010101110111010111
101000100010100010100010000010140010100010001010001
101011101110101010111010111010101110111011101111101
101000001000001000101010001000100010001000100000101
101011111110111111101011101011111011111110101110101
101010000010000000101000101010000010000000100010001
101010111011111110101110101110111110111111111011111
101010101010001010000010100010100000001000001000101
101110101010101011111010111010111011101010111110101
100000101000101000100010001010001010001010000000101
101111101111101010101110111011101010111011111111101
100000100000101010000010100010001010001010000000001
111110111010101111111110101110111111101010111111101
100010001010100010000010100000100000001000101000001
101011101010111010111010111111101111111111101011111
101000101010001010001010100000100000100010001010001
101011101011101011101010101110111110101110101010101
101000000010001000001000001000000000100000100000101
111111111111111111111111111111111111111111111111111

D
