151111111111111111111111111111111111111111111111111
100010000010100000000000000000001000000010000000001
111010101010101111111111111011111010111011111110101
100010101000101010000010001000000010001010000010101
101110101111101010111010101011111111101010111011101
101000100010000010101000101010000000101000100000101
101111111010111110101111101010111110101111111110101
100000001000100000100000101010001000100010001000101
111111101111101111101011101011101011111010101011101
100000100000001000001000101000101010001010101010001
101110111111111011111110101110101011101010101010101
100010100000101000001010001000101010001000101000101
101010111010101111101011111011101010111111101111101
101010000010001000100000001000001000100000001000101
101011111111101010111111101011111111101111111010101
101000001000101010100010001010000000101000001010001
101111101010101110101010111110111110101010111011111
101000101010100000101010100000100000001010001010001
101010101110111011101010101111111111111111101011101
100010100010100010001000101000000000100000101000101
111110111010101110111111101011111110101110101110101
100010001010000010100000001010000010001000100010001
101010111010111110101111101010111011111011101111101
101010100010100000101000101000101000001010000000001
101014101111101111101110101111101110111010111111111
101000100000001000001000100000001000100010100000001
101111111111111011111010111110101011101110111110101
100000001000001000000010100010101000100010000010101
111111101110101111111110101010111110111011111011101
100000100000101010000010101010100000101010001000101
111011111111101010111010111010101111101011101110101
100010000000101010101010000010001000001000100010101
101110111110101010101011111011111011101110101010101
100000100010001010001000100010000010001000101010101
101111101011111011101010101110111110111011101110101
101000101000100010001010100010100010101010000010101
101011101110101010111010111010101110101011101010101
101000000010001000001010001000101000101000101000001
101011111110111111111011111111101011101110111111111
101000100010001000001000000000001000000010000000001
101011101011101011101111101110111111101111111011101
101010001010001010000000100010001000101000001000101
101110111010111011111110101111101010101011101111101
100010100010101000001000101000101010001000100000001
111010101110101111101011111010101011111110111111101
101000100010000000101000000010100000100000101000001
101111111011101111101111111110111111101111101011111
100000001010001000101000000010100000101000001010001
101111111011111010101011111010101110101010111011101
100000000000000010001000001000001000001010000000001
111113111111111111111111111111111111111111111111111

U
