111111111111111111111115111111111111111111111111111
100000000000100000100000000010000000100000001000001
111111111110111010101011101110111110101111101011101
101000000010001010101000101000100010100000100000101
101010111111101010101110101011101010101111111110101
101010001000101010000010101010001010101000000010101
101011101010101111111110101010111010101011111011101
101010100010101000001000101010100010101000101000101
101010111110101011101011111010111110101110101110101
100010001000101000101000100010100010001000100010101
101110101011101010101110101110101011111011101110101
101000101000001010100000100010001000001000100010101
101010111111111010111110111010111110101110101010101
101010000000100010001000001010100000101000101000001
101111111010101111101111101011101111111010111111111
101000001010001000100000101000100000100010100000001
101011101011111010111110111110111110101111101111101
100010001000000010000010000000000010101000000010001
111110111111111111111011111111111010101011111110101
100010100010000010001000001000001000100010100000101
101010101011101010101111101011101011111010101111101
101010001000101000100000001010101010001000101000001
101011111110101111101111111010101110101111101111111
101010000010101000101000001010100000100010001000001
101010111010101010111011101010111111111010111011101
101000101010101010001000101010000000001010000010001
101111101010111011101110101010111111101011111010101
101000100010000010101000100010101000101000001010101
101011101111111110101011111110101010101111101110101
101000101000001000100010000000001010100010001000101
101010101010101011111110111111111010101010111011101
101010001010101010000000100000000010101010100410101
101111101110101010111111101111111110101110101010101
101000100000101010100010101000001000001000101010001
101010111111101010101010101010111011111011111010111
101010100010000010001000101010000000100010000010001
101010101011111011111110101110111110101110101111101
100010101000001000000010100010100010101000101000101
101110101111101111111110111011101010101011101010101
100010101000100000000000101010001010101000100010101
111110101010111111111111101010111011101111111110101
100000100010000010001000001010001000001000000010101
101111111111111010101011101011101111111011111010111
100000100000000010100010001000100010100000001010001
111110101111111110111110111010111010101111101011101
100000101000000000001010001010001010001000001000101
101111101011111111101010111011111010111011111110101
100000001010000010001000100010000010100010000010001
101111111110111010111011101110111111101110111011101
100000000000100000100000100000000000001000001000001
111111111111111111111111111111111111111311111111111

U
