111111111111111111131111111111111111111111111111111
101000000000001000000010000000100000100010000010001
101110111111101110111011101110101010101010111010101
100010001000000000101000100010001010101010001000101
111011101110111111101110111111101010101011111111101
101000100010100010000010001000101010001000000000101
101110111011101010111011101010111011111111111110101
100010001000001010001000101010001010000000001000101
101011101111101011101010101011101010111111101011101
101000100000101000101010100010001010100000100010001
111010111110111110101011111110111010101110111111101
100010101000100000101000000010000010101000000010001
101110101011101111101111111011111110101111111010111
101000001000001000001010001000001000100000100010001
101111101111111011111010101111101011111010101111101
100000101000001010000010100000101010001010101000101
101110101011111011111010111110101010101110101010101
101010100010001010001010100010100010100000101010001
101010101110141010101010101010111110111111101011111
101010101000101000101000101010000010001000001000001
101010101011101111101011111010111011101011111011101
100010101000100000001000100010001000001010000000101
111110101110111111111110101111101111111010111111101
100000101010000010001000001000001000001010001000001
101111101011111010101011111010111111101010111011101
101000101000101010100010000010100000101010100010001
101010101010101010111110111110101110101011101111111
101010101010001010001010000010100010100000101000001
101011101011111011101011111010111010111110101011101
101000101010001010000000001010101010000010100010001
101010101010101010111111101010101011111010101110101
101010001010101010100000101010001000001010101010101
101011111010101011101110111011111111101010101010101
101000100010101010001010001010000000001010100010101
101110101110101010111011101010111111111010111010111
100010001000100010100000101000100000000010001010001
101011111011111110101010101111101111111111101111101
101000000010100000101010100000101000000000100000101
101111111110101110111011111110101011111011111110101
100000000010000010001010001000101000001000001000101
111111111011111111101010101011101011111010111011101
100000001000000000001010100010001010001010001010001
101111111111111111111010111110111110101111101011101
100000000000000000001010001000100010100000001000001
101111101111111111101011101110101010111111111111101
101000101000100010001000100010001010100000100000001
101010101010101010111110111010111010101110101111111
101010100010101000000000100010100010001010001000001
101110111110111111111111101111101110111011111110101
100000000010000000000000000000001000000000000000101
111111111111111111111111111111111111151111111111111

U
