111111151111111111111111111111111111111111111111111
101000000000000010000010000000000010000000100000001
101111101110111011101010111111111010111110101111101
100000100010101000101000100000001000100000101000101
111110111010101110111011101111101111101111101010101
101000100010100010001000101000000000101000101010101
101011101110111011101110101011111110101010101011101
101010100010001000100010101000100010001010000010001
101010111011101011111010101110101011111011111110101
101010000010001000001010101000101000100000001000101
101011111010111010111010101011101110101111111011101
101000001010101010000010101000100010100010001010001
101111101110101011111111101111101110111010101010111
100000100000101010000000101000101000001010100010001
111011111111101010111110101010101011101010111111101
100010001000001000100000101010001010001010001000101
101110101011101111101111101011111011111011101010101
101000101010000010100000100000001000001000100010101
101011101010111010111110111111111011101110111110101
101010100010101010000010000000001000100000100000101
101010111110101011111011111111101111111111101111111
101010001000100000001000000000101000400000100000001
101010111011111111101011111011101011111110111111101
100010100010000010100010000010001000100010000000101
101110101110111010111110111110111110101111111110101
100010101000100010000000101000100000100000000010001
111010101011101110111111101011101111101111101111101
100010100000100010100000001000001000101000100000101
101110111111111010111110111111111011101010111110101
101000000010000010000010100000100010001010000010001
101011111110111111111010101110101010111110101111111
100010000000100000100010100010101000100010101000001
111010111111101011101110101110101111101010111010101
100010100010001000100010001000101000001010000010101
111110101010111110111011111010101011111011101110101
100000101010001010001010001010101000101000100010101
101111111011101010111010101011101110101110111110101
100000100010001010000000101000100000100010000000101
101110101110111011111111101110111111111011111111101
100010100000000000100010000010000000001000001000101
111110101111111110101011111011111011101011101010101
100000100010000010101000101000001010101000101010001
101111111110111010101110101111101010101110111011111
100000001000100010100010100000000010000000100010001
101111101011101110111010111110111111111111101110101
100010101010101000100010000010100010000000101000101
111010101010101111101111111010101010111110101011101
101000100010100000001000000010101010000010001010101
101110111110111111111011111111101011111011111010101
100000000000000000001000000000001000000000000010001
111111111111111111111111111111111111111111111113111

L
