111111111111111111111111151111111111111111111111111
100010100000101000000000000000100000001000001000101
111010101010101010111011111110101110101110101010101
100010101010101010001010000010101000100000100010101
101110101010101011101110111011101011111111111110101
100010101010100000100000001000001000000000001010001
111010101010111111111111111111111111101111101011101
100010001010000000100010000000100000100010101010001
101110111011111110101010111110101110111010101010111
100010101010000010001000100000001000100010101010001
111010101011111011111110111111111011101110101011101
100010001000100010000000100010001010000000101000101
101111101110101010111111101010101010111111101011101
101000101000101010000010001000101010001000001000001
101010101011101111111010111111101011111011111111101
101010101010100000000010001000101000001010001000101
101010101010101111111110111010101111101010101010101
100010101010000000100000100010001000101010100010101
111110101011111111101111101111111011101010111110101
101000101000100000001000101000000010001000100000101
101011111110101111111010101011111010111011101111101
100010000000101000000010101010001010001010001010001
101110101110101110111110101010101111101110111010111
101000101000100010101000101000101000100000100010001
101111101111111010101011101111101010111111111011101
101000100000000000101000100000100010000010000000101
101010101111111111101011111110101111101011101110101
100010100010001000100010000010101010001000001000101
111110101110101110101110111010101010111111111011101
100010101000100010001000100010101010001000001010001
101010101011111010111011101110101011101010111010111
101010101010001010100010101000100000101010100010001
101110111010101010101110101110111110101110101111101
100010000010100010101000101000100010100010001000101
101011111110111111101010101011101010111011101010101
101000000010000010001010000010001010001000101010001
101111111011111010111111101111101111101110101011111
101000101000001010000000101000100000100010101010001
101010101110111010111110111010111110111010101010101
101010100010100010000010000010000010001010101010101
101010111010101111111011111011111010111010101010111
100010000010001000000010001000100010000010101010001
111111111011111111111110101110101110111110101011101
100010001000100000000000100010101010000010101000001
101011101110101111111111111011101011101110101111101
101000000010001000100400001010001000101000101000001
101111111111111110101011101010111010101011111011111
100000100000000000101010001010001010001000100010001
101110101111101111101011111011101011111110101111101
100010000000100000001000000000001000000010000000001
111111111111131111111111111111111111111111111111111

D
