111111111111111111111111111111111111111111111111111
101000100000100000100000101000000000001000000010001
101010111010111010101110101011111111101011101011101
100010000010000010001010101000100000100010101000001
111111111111111111111010101110101110111110101111101
100010000000000000000010100000101000100000101000101
101110111011101111111110101111101111101110101010101
100000101000101000000000101000100010001000101010101
101111101110101011111111101110101010111011101010101
101000000010101010001000100010001000001000100010101
101110111010101010101110111011111111101110111110111
101000101010101000100010001000000000101000000010001
101011101010111111111010111111111110111011111011101
100010001010100000001010000000000010100010100000101
111110111010101110111010111110111110101110101111101
101000000010001010000010100010100000001000001000001
101011111111111011111110111010101111111111111011111
100010000010000000100010001010001000100000001000001
101111111010111010101011101011111110101111101111101
101000001010101010001000100010000000100010100000101
101011101010101011111111111011101110111010111110101
100010001010001010001000001000001010001010000010001
111110111011101010101010111111111011101010111011101
100010001000101000100010000010001000001010001000001
101111101010101111111011101110101011111010111111111
101000001010001000001000100000100010001010100000001
101011111011111011101110111110111111101011101111101
101010001000001000100010100010000000001000101000001
101011101011111010111011101011111111101110101011111
101000100010001010101000001000100010001000101000001
101110111110101110101111111110101110111010101111101
100010001000100010100000100000100000001010100010001
101011101011111010111010101111111111101011101110101
101010001000101010001010100010000000101000001000101
101010111110101010101010111010111110111111111011111
101010100000101010101010001000101000100000000010001
101110111011101010101111101111101011101110111110101
100010000010001010100010000010001010000010100000101
111011111110101011111010111010111010111011101111101
100000100010101000100010100000100010100010000010003
101110111010101110101110111111101111101110111110101
501000100010100000101010000000101000100010101000101
101011101110111111101010111110101010101010101011111
101000100010100000001010100010101010101000001000001
101110111010101111111010101010101010111111111111101
100010000010001000100000101010101010100000001000141
101011111011111010101111101010101010101111101010101
101010000000100010100000101010001010001000100010101
101011111111101110111110111011111011111010111110101
101000000000000010000000000000000010000010000000001
111111111111111111111111111111111111111111111111111

D
