111111111111111111111111111111111111111111111111111
101000000000000000000010000000000010001000000010001
101111111110111111111010101111111110101010111010101
100010000010000000001010100010000000100010001000101
111010111010111111101010111010111111111111101111101
100010101010100010001010001000100010000000100000101
101110101010101010111111101111101011101110111110111
101000100010101010100000001000001000001000100010001
101011101110101010101111111011111111111011111011101
100010101010001010001000001000000000100000000000103
111110101011111011111011101011111010111111111110101
100000001000001000001010101010001010000000000010101
101111111011111111101010101110101111111011111010101
101000001000000000100010100000101000001010000010101
101011101111111011111110101111101011101110111011101
101010100000001000001000001000100010100010100010001
101010111111101110111011111010111110111010101110101
100010100000001000100010001010100000001010101010101
111110101111111010101110101010111111101010101010101
100000101000000010100010101010001004100000100010101
111110101110111110101110101011101010111111111110101
100000100010001010101000100010000010000000000000101
101110111011101010101011101111111111101111111111111
101010100010001000101000101000000000101000000000001
101010101110111011101110101011111110101011111110101
101000100010100010001010101000100010101010100010101
101111111010111110111010101110111010111010101011101
100000100010100010000010101000000010001000101010001
101110101110101011111010111011111110101110101010101
100010001000001000000010000010000010100000101000101
111011111011111111111110111110111011111111101111111
101000101000100010000010100000100010000000001000001
101110101110101110111011101111101110111011111011101
100000100000100010100000001000001000100010001010101
101111111110111010111111101111101010111110101010101
100000100010000010000010001000101010000000101010101
111110101010111111111010111010101111111011101010101
100010101010100000001010100010100010001000101000101
101010101011101111101011101110111010101111101110101
101010001000001000101000001000100000100000101000101
101111111111111010101011111011111111111110101011101
100000100000000010101000001000001000000000100010001
111010101110111110101111101111101111101111101110101
100010100010000010100010000000100000101000001010101
101110111011111010111010111111111110101111101010111
100010001000001010001010100000000010101000101010001
101011111110111011101010101111111010101010101011101
501000100000100010001010101000001010100010100000101
101110101111101111111011101011111010111110111111101
100010000000100000000000001000000000100000000000001
111111111111111111111111111111111111111111111111111

L
