111113111111111111111111111111111111111111111111111
101000001000100000100000100000000000100000001000001
101110101010111110101010111011111110111011101011101
100010100010001000101010000010100010100010001000101
111010111111101011101011111110101010101110111011101
101000100010001010001010000010001000100010100010001
101111101110111010111011101110111111111010111010111
100000001000100000001000100010001000000010001010001
111010111011101111111110101011101010111111101011101
100010100010101000100004101010001010001000001000101
101011101110101011101111101010111011101111101111101
101010001000000010001010001010100000100000100010001
101110111111111110111010111010101111111110111010101
100010000000000000100000100010101000100000100010101
111011111111111111101111101110111010101111101110101
100000001010000000101000100000100010001000001000101
101111101010111011101011111111101111111011111110111
100010101010101000001010000000100000100000000010001
101010101010101111111010101110111110111111111011101
101010000010100000001000100010000010001000001000101
111011111010101110101011111011111011101011101110101
100010001010101000101000100010001000001000100010001
101110101110111011101111101110111111111110111011101
101000100000100010100010001000001000000010101000001
101011111111101110111010111110101010101110101111111
100010000000000010001010000010100010101000100000001
101111101111101011101010111011111010111011101111101
101000101000101000101010001000001010000010000010001
101010111010101110101011101111101111101111111011101
100010000010101000100000101000100000100000001000101
111111111110111011111110101010101110111111101010111
101000000010001000001000101010100010100000101010001
101010111111101111101011111010111110101111101111101
101010000000100010001000000010001000100000100000001
101011111110111010111111111111101011101110111111101
101010001000001000100000000000100010001010001000101
101010111011101111111110111110111110111011101010101
101010001010001000000000100010000010101000100010101
101011101010111110111110101011111110101010111110101
100000001010000010001000101000100000101010100010001
111111111011111011101111101110101111101010101011111
100010001000001000001000001000101000000010001000001
101010101111101111111011111011101111111111111110101
101000100000100000100010001000100000100000001000101
101011111110101110101111101110111110101111101011101
101010001000100010100000001010000010100010001000101
101110101110111110111111101011111010101010111110101
101000100010000000100010001000101000101010100000101
101011111011111111101010111010101111111010101111101
100000001000000000001000000010000000000010001000001
111111111111111111111111111111111511111111111111111

U
