111111111111111111111111111111111111111111111111111
101000100000000000000010000010000010000010000000001
101010111011101111111110101110111010111010111011111
101010001010001000000000101000101000101010101000001
101011101110111011111111101011101111101010101111101
101000100010100010000000101000000010001010100000101
101110111010101111101110101111111011101010111010101
100010100010000000001000100000001000101000000010101
111010101111101111111111111110101110101111111110101
100010100000101000000000000010101010001000001000101
101110111110111011111111111010101010111011101111101
100000100010001000001000001010100010100010001000101
111111101011101110101111101010111110101110111010101
100000001000100010101000100000100000101010100010105
101011101111111010101010111110101111101010101110101
101010001000000010100010001000100000101000101000001
101010111011111110111111101110111011101011101111101
101010001000101000001000100010101010001010001000101
111011101110101011111010111010101010111010111010111
100010001000100010000010000010001010100010100010001
101111101011101110111111111111101010101110101111101
101000101010101000100010000000101010100010001000101
101010101010101011111010111110101010111010111010101
101010101010101000001010000010001010001010001010001
101010101010101111101011111011111011101011111011101
101010101010000000101000000010000010101000100010001
101010111011111111101111101110111110101110101111111
100010100010000000001000100010100000100010100000401
111110101110111110111010111010111110111010111111101
100000101000100010100010001010000010100010000000001
101110101010101010101111101111111010101111111111101
101000101010001010101000001000000010100010001000101
101111101111111010101011111011111110111010101010101
100000100010000010101000001000001000001010101010101
101110111010111111101111101111101110111010101011101
101000101010000000000010100000101000100010100010001
111010101011111111111010111011101011101110111110111
100010001000000000100010001000000010001000100000101
101111111111111110101110101111111110111010101111101
100000000010001000101000100000100000100010100000001
111111101011101011101011101111101111101011111111101
100000001000001010000010001000001000101000000010001
101111111111101011111110111011111010111111101110111
100010100000001000100000001000100010000000001000101
101010101111111110101111111110101011111110111011101
301010101010000000101000001000101010000010100010001
111010101010111111101011101011101010111011101111101
100010000010001000001010001000101000101000101000101
101111111111101111111010111110101111101110101010101
100000000000000000000010000000100000000010000010001
111111111111111111111111111111111111111111111111111

L
