111111111111111111111111111111111111111111111111111
101000001000101000000000001000100000100000000000001
101110101010101010111111101010101110101111111011101
100010100010100010100000100010001010100000001000103
111010111110111010111110111111111010111111101110111
100010100010001010000010100000000010001000000010001
101110101011101111111010101111111011101111111111101
100000101000100000001010001000001000101000000000101
111111101110111111101010111110101011101011111110101
100000100010001000100010000010101000001000100000001
101111101110101011111111111010111111111010111111101
100000001000101000001000001010000010000010000014001
111111101011101111101010111010111010111111111010111
100000101010101000101010000010001000100000000010101
101110111010101010101011111111111111101111111110101
101000100010101010001010000000001000100000000010001
101110101110101011101011101111101010111111111011101
100010001010001010001000100010100010001000000010101
111011111010111011111110111010111111101011111110101
100010001000100000001000100010000010001000100000101
101110101011111011101011101110111010111110111110101
100000101000001010101000001010001010000000100000101
101111101111101010101111111010101111111111101011101
100000100000101000101000001000100000100010001010001
111110111110101110101011101011111010101010101110111
101000100000100010100010100010000010101010100010001
101011101111111010111110111110111110111010111011101
100010100010001010000000001000100010001010101000001
101110111010111011111111111011101011101010101111111
100010100010100000000000001010001000000010001000001
111010101110101111111111101010111111111111101011101
500000101000001000100000100010100010000000001000101
111111101111111010111110111110101010111111111110101
100000001000001010001000100000001010101000100000101
101111111011101011101011101111111010101010101011101
100000001010101000101000001000100010100010001010001
101111101010101110101011111010111110101111111010111
100000101010100000101000100010100000100000100010001
111110101010111111101111101110101111111111101111101
100010100010001000100000001000100010000010001010001
101010111110101011111111111010111010111010111010111
101010100000101000000010000010101000101010001000101
101010101011101010111110111110101111101011101011101
101010101010001010001000100000100000101000001000101
101010101011101111101011111011101110101111111110101
101010101000101000001000001000001000001000001000101
111010111010101011101111101111101111111011101011101
100010001010100010101010001000101000000010001000101
101111101110111110101010111010111011111110111110101
100000000000100000000010000010000000000010000000001
111111111111111111111111111111111111111111111111111

D
