111111111111111111111111111111111111111111111111111
101000000000001000001000000010000000040000100000001
101111101011111011101011111010111110111110111111101
100000101000001010101000001010001010100010000000105
111110111110101010101111101011101010111011111110101
101000100010101000100000101000100010100000000010001
101011101011101011111110101110111010101111101111101
100010001000100010000010101010001010100000101000101
101110111110111110111010101011101010101110111010101
100000101000100000101000101000100010101010001010001
111111101011101111101110101010111110101011101011111
100000100010001000000010101010001000100000101000001
101110101110111011111010101011101011111111101111101
101000100010100010001000100010001010000000100000101
111011111010101110101111111110111010111110101111101
100010000010100000100010001000101010100000101000001
101110111110111111111110101011101010111011101011111
101000100010000000000000100010001010001000001000001
101011111010111111111111111110101010101111111111101
101000001010100000000000100000101010100000000000001
101111101010111110111010101011101010111111111111111
100010001010000010001010101010001010000000100010001
101010111011111011111010101010111011111111101010101
101010001000001010000010101010101010000010001000101
101111101010111010111110111010101010111010111111101
100000101010001010001000100010001010001000100000001
101110101111101011101110101111101011101111101111101
101000101000100000100010100010001000001000001010001
111010101010111110111010111011111111101011111010111
100010101010100010000010000010000000101010000010001
101111101010101011111111101110111110111010101011101
100000101010001000100000001000100010001010101010001
111110101011111110101111101011101111101011101010111
300010101010000000101000101000100010001000101010101
101010101011101111111010111110101010111110101110101
101010101000101000001010000010101010000000100010001
101010101110101110101011111010111011111111101011101
101000101000101000100010001000100000000000101000001
101111101011101011111110111111101111111110101111111
101000001010001010100000000000100010000010100000001
101011111010111010101111101011101010111010111111101
101000001010100010101000101010001010100010001000101
101111101010101010101010111010111010101111111010101
100000100010101010001010000010001000100010001010001
111110111110101011101011111011101111111010101011111
100000001000101000101010000000100010001000101010001
101111101011111110101011111111111010111111101011101
101000001000000010101000000000000010000000100010001
101111111111111010101111111111111111111010111110101
100000000000000000100000000000000000000010000000101
111111111111111111111111111111111111111111111111111

R
