111111111111111111111111111111111111111111111111111
100000100000000010000000001000001000000000000010001
111110101011111011111110101011101011111110111011101
101000101010000010000000101000100010000000101000001
101011111010111110111111101110111110111111101111101
101010001010100010001000100010100000100000000010001
101010101010101010101110111010101111101111111010111
101000100010001010101000100010101000101000001010001
101111111111111011101011101111101011101011111011101
100000001000001010001010001000001000100010000010001
101111101111101010111010111110111010111010111010111
100010101000101000100010000000100010001010100010001
111010101010101111111011111111101110111010111111101
100010101010000000000000000000100010000010000000101
101110101011111111111111111011111011111111111010101
101000001010000000001000100010000010000000100010101
101110111010111111101010111110111111101110101111101
100010000010001000100010001000100000100010100000101
111011101111101010111111101011101010111110111110101
100010001000001010001000100010001010000000000010001
101111111011111010101010111111111011111111111011111
100000001010000010100010100000000010000000001000001
101111101011111110111110111110111110111111101111101
101000001010000000100010000010001000100010101000101
101011111010111111111011111010101011101010101010101
101000001010000010000010001010100000001000100010101
111111101011111010101011101011101111111110111110101
100000001000001010101010001000101000100000100000101
101111101111101010101010101110111010111011101111101
101000001000101010101000100010100010001000100010001
101011111010101010101011111110101111101111111010111
101000100010100010101010000000101000101000000010101
101111101110111110101110111111101110101011111110101
101000000010100000100010100010000010001010000000101
101011111110101111111010101010111011101010111111101
101010000000100000001000101010001000101010000000101
101014111110111111101111101011101110101011111110101
100010001000001000001000001000100010101000001000101
101111101111111011111011101110111110101011101110101
100010001000100010001000100010100000101000100010003
111010101010101110111110111010101111101111111011101
101010101010101000000000100010101010001000000010001
101010111010101111111111101110101010111011111110111
101010000010100000000010001000101010100000100010001
101011111110111111111010111110101010101110111011101
500010000010001000001010000010101000101000100000101
101111101011101011101011111010101011111011101110101
101000101010001000101000100010101010001010100010101
101010101010111110101110101110101010101010101011101
100010001010000000100000001000001000100010001000001
111111111111111111111111111111111111111111111111111

U
