111111111511111111111111111111111111111111111111111
100000000010001000000000001000000000100010001000001
111111111011101011111111101010111110101010101011101
100010000010001010100000100010001010001000101010101
111010111110111010101110101111101011111011111010101
100010100010000000101010101000001000001010000000101
101110101110111111101010111011111111101010111111101
100010100010101000101010001010100000001010000010001
111010111010101010101011101010101011111011111010101
100010100010001010001000001010001000000010001010101
101010101111101011111011111011111111101110101010111
101010101000001000101000001010000000101000100010001
101010101011111110101111101010111110101011111111101
101010101000000010100000101010000010101000000010001
101010101111101110111110101011111010111111101110101
101010100000001000100010101010000010000000001000101
101110101111111011101010101010111111111111111011101
101000100010000010001010001000100000100000100010001
101011111010111110111010111111101110101110101110111
101010001010000000001010000000001010001000100010001
101010101011111111111011111111111011111011111011101
101010101000001000001000000000100000100010000010001
101010111111101011101011111110101111101110111110111
101010000000001010101000100000100000001000000010001
101011111011111010101110101111101111111011111011111
101000001010001010001000101000100000001000001000001
101111101010101010111111101010111111101111101111101
100000101010100010000010001010100000001000001000101
101110101110111111111010111110101111111111111010101
101000100010001000001010100000100000000000000010101
101011111011101011101010101010111111111111111110101
101000001010001000101010101010001000000000001010101
101111101010111110101010101011101011111011101010101
100000101010001000101000101010001000101010000010001
111110101011101011111111101010111110101011111111101
100000101010001010001000001010001000101010000040101
101111101010111010101011111011101011101010111110101
101000101000100000100000001000101010001000100010001
101011101111111011111111111110101011101111111011111
101000001000001000100000100000101000101000001000001
101110111110101111101110101111111110101010101111101
100010000000100010001010101000000010100010100000001
101011111111111010111010101011101010111010111111101
101010001010001000100000001000101010001010000010001
111010101010101011111111111110101111101111101010111
100010101000100010000000000000100010001000101010001
101110101111111010111111111111111010111010111011101
100010100000001010100000001000001000100010100010001
101010111111101110111110101110101111101110101110111
101000000000100000000000100000100000001000001000001
131111111111111111111111111111111111111111111111111

R
