111111111111111111111111111111111111111111111111111
100000000000101000001000001000100000000000000000101
111111111110101011101010101011101111101111111110101
100000101000100000100010101000000010001000000010101
101110101011111111111110101111111010111011111010101
101010001000000000000000100000001010001000101010001
101011101111111111111111111111101011101110101011101
101000001000000000000000100010001010100010101010001
101111111011111110111110111010111010101110101011101
101000000010100010100000100010101000100000101000101
101011111110101010101111101110101110111111101110111
101000100000101000100000001000100000001000000010001
101110111010101111111011111011111111101011111011101
100010001010101000100010000010000010000010000000101
101111101011101010111110111110111011111011111011101
101000001000100010000000100010101000100010001010005
101011111110111111111111101010101110101110101110111
101000000010000000001000001000101000101000100010001
101111111010111111101010111111101011111011111011101
100000101010000010100010100010000000001000101000001
101110101011111010111110101110111111101110101111101
100010001010001000000010100000001000100000100000001
101011111011101111111010111111101010111111101111111
101010000010000010000010000000101010001010001000001
101010111110111110111111111110111011101010111010111
101000100010000000100010000010000010001000100010001
101111101011101111111010111011111010111011101111101
100000101000101000000010001000001010001000101000101
111110101110101011111011101111101011101110101110101
100010001010100010001000100000101000100010100000101
101111111010111110111110111110101111111010111110101
100000000010101000000010000010101040100010100000101
101110111110101011111011111010101010101110111111101
101010000000100010100010000010100010001010000010001
101011111111101110101010111110111111111011111010101
101000100000000000101010001010101000000010000010101
101010111111111110101111101010101011101010111110111
100010000000101000100000000010100010101010000010001
111111111110101011111111111110101110101111111011101
100010100000100000000010001000101000100000001010001
101010101111111111111010111011101010111111101010111
101000100010000010000000100010001010000000100010001
101111111011101011111110101110111111101011111110101
101000001000001000000010101000000000101000000010101
101011101111111111111010101111111110111111111010101
300010100000100000001010100000100010000010001000101
101110111010101011111010111110101111111010101111101
101000001010101000100010100010100000001000100000101
101011101011101110101111101010101111101111111110101
100010001000000010000000001000100000100000000000001
111111111111111111111111111111111111111111111111111

R
