111111111111111111111111111111111311111111111111111
100000100010000010000000000000001000100000100000101
111110101110111010111110111111101010101110101110101
100010100000001010001010100000101010001010100010001
101110101111111011101010101110101011111010111011101
101000100010001010001010100010101010000010001000101
101011111110101010111010111011101011101011101110101
101000000010101000000010100010001000101000100010101
101111111010101111111110101010111110101110111010101
100000100010101000100010101010000000101000001000101
101011101110101010101010101011111111101111111111101
101000100000100010001010101000100010001000100000101
101110111111111111111010101110101010101010101110101
100010000010000000001010100010101010100010100410001
111111101110111011111010101010101010111110111011111
100000001000101000000010101010101010100010001010001
101111111011101111111110101011101010101010111010101
101000000010100000000000101000001010001010000010101
101011111110101111111011101111111011111011111110101
101010000000001000001010101000000010100010000000101
101010111111111011101010101011111010101111101110111
101010100000100010100010101000001000100000100010001
101010101111101110111110101111101110111110111110101
100010001000001000000000100000100010000010000010101
101110111011111011111111111110111011111111111011101
101010100010001000000000001000101000000000001010001
101010101110101111111111101011101111111011111010111
101000101000101000001000001010000000100010000010001
101111101011101011101010111010111111101010111110101
100000001010001000100010100010100000101010000010101
111111111010111110111110101110101110101111111011101
101000000010100000100010101000101000100000001000101
101011101110111010101010101110101011111111101110101
101000100010000010101010100010001010000000100000101
101110111011111110101011111010111010101110111111101
101000101010001000101000001010101000100010001000001
101011101010111011101111101010101111111011101011101
101000001010100000100010100010001000001010101000101
101011111010101111111010111111101110111010101011101
100010001010001000100010000010000000100010101010001
111110101010111010101111101010111111101110101010101
100000100010001010100010001010001000101000101010101
101011111111111010111010111011111010101110101110101
101010001000000010001010101000001010100010000010101
101010101011111111101010101111101010101011111010101
101010100010001000001010100000100010101000101000101
101110111110111011111010111011111110101110101111101
101000100000001000100010100010000010101000100000101
101011111111101110101110101110101110111011101011101
100000000000000010000000100000100000000010001000001
111111111111151111111111111111111111111111111111111

D
