111111111111111111111111111111111111111111111111111
100010000010000000000000000010000000101000000000001
111010101010111011111111111010111110101011101111101
101010101010100010000000100010101000100000100010101
101010101110101110111010101110101011111110111010101
100010100000101000100010100000101000000010100010101
101110111111141110101111111111101111111011101110101
101000100000100010100000000000001000001010001000101
101011111010111011111111111011111010101010111011101
101000001010100010000000000010000010101010101000101
101111101010101110111111111110111110101010101010101
100010100010101000100000001000001000101010101010001
111010111110101011101111101011111011101010101011111
100010000000101010001000100010000010101010101000001
101111111111101010111110111110111110101010101111101
301000001000001010000000101000101000001000101000001
101110101011111011111110101011101011111111101011111
100000100010100010000000101000100010000010000010001
111111111110101010111111101110111110101010111110111
100000000000101000100000000010000000101010100000001
101111111110101111101011111011111111101110101111101
101000000010001000001010001000100000100000101000001
101110111011111010111110101110101011111111101011101
100010101000001010001000101010101010000000101010101
111010101011101111101011101010101010111110101010101
100010001000101000101000101010001010100010001010001
101111111110101010101110101011101110101011111011101
101000000000100010101000101000001000101000001000101
101110111111111110101011101011111011111110111110101
101000100000100000100010001000100010000010100010101
101011111011101111101110101111101111101010101010101
101000001010001000101010101000100010001000101000105
101111101010111010101010111010111010111111101111101
100000001000100010001010100010001010100000100010101
111111111011101111111010101110111010101110101010101
100000100010001000000010001010000000101000101010001
101011101111101111101011111011111111101011111010111
101000100000100000001000001000101000001000000010101
111110111110101111111111101010101011111011111110101
100000001000101000100000100010101000001010000010001
101110111011111010101111111110101111101010111011101
100010100010000010101000100010100010101010101000101
111010101110111110101010101010101010101110101110101
100010100000101000101010101010001000101000101000101
101111111111101011101010101010111110101011101011101
100010000000001010000010001000100010100000001010001
101010111011111011111111111111101010111111111010111
101010001010000010000010001000001010100010000010001
101011101010111110111010101011111011101010111111101
101000001000000000100000100010000000001000100000001
111111111111111111111111111111111111111111111111111

U
