131111111111111111111111111111111111111111111111111
101000000010000000001000100000001000000000000010001
101111101011111011101010101111111010111111111010101
100010001000000010100010101000100010001000000010101
111010111111111110111110101010101111101011111111101
101010100000001000000010100010001000101010000000101
101010101110101011111010101111111010101010111010101
101000100010101010000010101000000010001010100010101
101111111010111010111110111011111111111011101110101
101000000010000010000010001010000000100000101010101
101011111111111111111011101010111110111110101010101
100000100010001000001000101010000010000010001000101
111110101010101011101011101011111011111011111011101
100010001000101010000010001010001000001000100010001
101011111111111010111110111010101111101110111011101
101000000000001010101000100000100000101010001000001
101111101111101010101011101111101110101011101111101
100010001000101010001010001000001000101010001000101
111011111010101011101011111011111111101010101010111
100010000410101010001010001000000000001010101010001
101110111110101010111010101110111111101010111011101
100010001010100010100010100010100000100010001000101
111011101010111110101110111010101110111111101011101
100000101010000010100010001010101010000000101010001
101011101011111010111010101011101011111110101010101
101010001000101010100010101000001000000010100010101
101010111010101011101110101111111011101110111110101
101010100010001010001010100000100000101000100000101
101010111011101010111010111110111110111011101111101
101010001000101000100000001000100010100010100010001
101111101110101111111111111011101010101110101011111
101000101000100000100010001000101000100010001000001
101010101011111110101010101110101111111011111011101
101010001000001010001000100000100000001000001010001
101011111111101011111111111111101111101111101110111
101010000000001000000010100000100010100000100010001
101011111011111111101010101011111010111110111011101
101000000010000000001000101010000000100000001000101
101111111110101111111111101010111111101111101110101
100000000010100000100000001000101000001000000010101
111011111010111110101111111111101010111111111110101
100010100010000010101000000000001010100000000010101
101110101110111110101011111111111011101111111010101
101000000010100000100010000000001000100010001010101
101111111110101111111010111111101010111011101010101
100000000000100010001010001000001010001010001010101
101111111111111010101011101111101111101010101010101
101000100000100010100010100000100000001000101010101
101010111110101110111110111110111111111111101010101
100010000000100000000000000010000000000000001000001
111111111111111111111111111111111111111111111511111

L
