111111111111111111131111111111111111111111111111111
100000100000100000001000000000001000000010000000001
111110111010111110101110111110101011111011111011101
100010000010000000100010001400100010001000001010001
101111111111111111111011101011111111101111101110101
101000000010000000001010001000001000000000100010101
101011111010111011111011111011101110111111111010111
100000001010001000001000001000100010001000000010001
111111111011101111101111101011111011101011111111101
100000100010001000001010001010000010001000100000001
101110101110111011101010111110111110111110101011101
101000001000001010001010000000100010000010101010101
101110111011111010111011111111101110101110101010101
100010100010000010100000000010000000100010101010101
101011101110111110101111111010111111111010111010101
101000101010100010101000001010100000001010100010001
101110101010101010101110101010101110111010101110111
101000100010101000100000101000100010100010001000101
101011111010111011111111111110111010101111111011101
101000000010001000000000000010000010101000001010001
101111111111101111111111111011101111101011101011101
101010000000001000000010000010001000100010001000101
101010111011111011111011111011111010111110111110101
100010100010001010001010001000000010001000100000101
111010111110101010101010101111111111101010101111101
100010001000100010101000101000001000100010101000001
101111101011111110101111101011101010111110101011101
100010101000001000100000101010101010000010101010001
111010101111101111101110101010101111101110101110101
101000100000001000101000100010100010001000100000101
101110111111111010101011111110111010111011111111101
100010000000100010001000100000001010000000000010101
101011111110111011111110111110101011111111111010101
101000000010100010100010000010101000000010000000101
101110111010101110101011111010111111111011111111101
100010001010001000101000001010000000101000000010001
111011101011111110101110111011101110101111111010111
100010101010000000100010001000001000100000001010001
101110101110111010111011101111111011101111101011101
101000101000001010001010000000100010000000101000101
101010101011111011101010111110101111111010101011101
101010101000100010001010100010101000001010101000001
101010101110101110111010101110101011101110111111111
100010101000101010001010100000101000100010000000001
101111101011101011101010111110101110111010111110101
101000001010001000001010000010100010101010001000101
101011101010111111111011111010111010101011111011101
101000101010000010001000001010001000100010000010101
101110111011111010101111101011111111101110111110101
100010000000001000100000001000000000000000100000001
111111111111111111111111111111111111151111111111111

R
