111111111111111111111111131111111111111111111111111
101000000010100000000000100000001010000000100000001
101011111010101111111110101110101010111011101111101
101000100000101000001010000010101010001000101000001
101010111110101011101011111110101011101110101011101
101010000010100010001000100010101000101010001000101
101111111011111110111110101010101110101011111110101
100000001000000000000000101000100010000000000010101
111111101111111111111111101111111011111111111110111
100000100000001000000000001000001000000010000010001
101010111111101011111111111110101111111010111010101
101010000010001000000000000010101000001010001010101
111011111010111011111011111010111011101010101011101
100010000010101010001000001010000000100010101010001
101110111110101010101111101011111111111011101010111
100010101000100010101000101000000000001000001010001
111010101011111110101011101111111111101111111011101
100010001000100000101000001010000000100000101000101
101111101110101111101111101010111110111110101110101
100000100010100000100000100010000010100000100000001
101110111110101110111110111011111010101111101111111
101010000010101010100010100010000010101000000010001
101011111010101010101010111110111110101111111110101
100000001000100010101010000010100000100000000000101
111111101111111110101011111010101111101111111111101
100000100010000000101000001000101000100010001010001
101110111010111111101111101111101110111010101010101
101010001010100000101000100000001000001000100010101
101010111010101110101010111111111011111111111010111
100010001000101000100010101000000010000000000010001
111011101111101111111110101011111010111111111111101
100010100000001000001000100010001010001000001000101
101110101111111011101011101110101011101110101010101
100000101000000010100010100010101000100000101010101
101111101011111110111110111011101110111111101010101
101000001010000000001000001010001010100000101010101
101011111010111110101110111010101010101011101010101
101000100010001000101000100010101010001000001010401
101110101111101011101010101110101011111111111011101
100010001000101010001010100000101000000010001000101
111011111010101011101011111111101011101011101110101
100010000010101000101000000000101000101000001000101
101111111010111110101110111111101111101111101011101
101000000010000000100010000010001000100000101010001
101011111111111111111010111010111010111110101011111
101010000000000010001010101010000010000000101000001
101010111111101110101010101011111011111111111111101
101010100010100010100010001000000010001000000000001
101010101010111010111111111111111110101011111111101
100010001000001000000000000000000000100010000000001
111111111111111511111111111111111111111111111111111

L
