111111111111111111111111111111111511111111111111111
100010100000100010000010001000000010000000001000001
111010101011101010101011101011111010111110111011101
100010001000101000101010001000101010100010000010101
101110111110101111101010101110101010101011101110101
101010100010001010001000100010001000101000100000101
101010111011111010111111101111101111101110111111101
101000000000000010100000101000100010100010000000101
101111111111111110101110111010111010111011111110101
100000001000000010000010100010000010001010000000101
111111101011111011111110101111111111101010111110101
100000101000100000000010001000001000101010100010001
101011101010111111111011101110101010101010101011101
101010001010001000001000100000100010001010101010001
101010111111101011111110111111111110111010101011101
101000100000001000100010001000000010100010101000101
101111101011111010101011101111101110101111101110111
100010001010000010001000100000100000100000101010001
111011111010111111111011111110111011111110101011101
101000100010100000001000000010001010000010101000101
101110101110101111101111101011101110111010101110101
101000101000100010100010001010001000100010000000101
101011101011111010111010111110111011101111111110101
101000101010001010100010000010100010001000001000101
101110101010101010101111111010101110111110101011101
100000101010100010000000101000101010000000101000101
101111101010111111111110101111101011111111101111101
101000001010000000100000100000001000100000100000001
101110101011101110111011101111111110101010111111101
100010101000100010001000100000001000101010001000101
111011101110111011101110111111101010101011111010101
101010001010001000101000100000001010101010001010001
101010111011101111101011101111111010101010101011111
101010001000100000001010000000100010101000101010001
101010101011111111111011111110111011101111101010101
100010101004001000001000000010001000100010001010101
101111101011101011101111111010101010111010111010101
100000001010100010000010000010101010000010001000101
111111111010111110101110111111101111111110101111101
100000000010100000101000100000100000100010100000101
101111111110101111101011111010111110101011101111101
101000000000100000101010000010001000101000100000101
101111101110111110101011101111101011101110111110101
100000100010000010101000001000100010100010000000101
111110101111101110101111111010111110101011111111101
101000101000101000100010000010000000101000000000001
101011111010101011111110111111101110101111111111111
100010001010001000100000100000101000101000001000001
101110101011101110101111101110101111101110101011101
100000100010000010000000001000100000000000100010001
111113111111111111111111111111111111111111111111111

R
