111111111111111111111111111111111111111111111111111
100010000000100000100000000010000000100010000000001
111010111110111010111110111010111110101011101111101
100010100000000010001000100010000010001000001000005
101110101111111111101011101111111011111110111111101
100010101000000010001000100000001010000010100000101
111010111011111010111110111111101010111010101110111
101010001000001010000000100010101010101010100010001
101010101111101011111111101010101010101011111011101
101010100010001010000000001000101000101000000000101
101011101110111011111110111110101110101111111110101
101000100000100010000010001010100010000000100010101
101110101111101110111011101010111010111111101011101
100010100010001000001000001000100010100000001000101
111010111010111111101111111110101110101111111110101
100010001010000010001000000010101000101000000010101
101011101011111010111011111011101111101010111110101
101000101010001010000010001000001000001010000010101
101111101010101010111111101111111011111111111010101
100000001000101010000000100000000010000000100010101
101111111111111011111110111111101110101110101110101
101000000000000010100000100000001000100010001000101
101111111011111110101111101111111011111011101011101
100000100010000010100000001010000010000010101010001
111110101110111010111111111010111110111110101011101
100010100010001000100000000010001010001000001000001
111010111010101111101111101011101011101110111111101
100010000010100000101010001010001000100010001000001
101111111110111110101010111110111010111011101011111
100010000000100010001010100010001010001000101010001
111010111111101011111010101011101111101110101010111
100010001000001000100010001000100010000010101010001
101111101011111110111011111011111010111010111011101
100000100010000010000010001000001000101010100010001
101110111111111010111110101111101111101010101110101
100010000000000010100000100000000000100010001000101
111110101111111010101111111110111111101111111110101
300010101000001010100010001000100000001000000000101
101011101010111010111010101011101111111110111011111
101010001010000010100010101000101000000010001000001
101010111011111110101110101110101010111010111110101
101000101000000010101000100000101010101010100010101
101111101111111010101110111111101110101011101011101
100010000010000010100010100000101000100000101000101
111010111010111110111010101110101011111110101110101
100410101000100000100010001000101000001000100010001
101110101111101111101111111111101011101011111011111
100010000000101000100000000000001000101010001000001
101011111111101110111111111111111111101010101111101
101000000000000000000000000000000000001000100000001
111111111111111111111111111111111111111111111111111

L
