111111111111111111111111111111111111111111111111111
501000000010001000000000100000100010000000100000001
101110101010101111101110101110101010111110101111101
100010101010100000100010101010001010000010101010001
111011101010111110101011101011111011101110101010111
101000001000101000101000101000001000001000100010001
101111111111101011111110101010111111111011101111101
100000000010001010000010000010100010001000001000001
111011111011101011101011111110101010101111111011101
100010100010001000001010000010101010101000100010101
101110101110111111111010111011101010101010101110101
101000100010000000001000100010001000101010101000101
101110111010101111101111101110111111101010101011101
100010001010100000100000101000100010000010001000101
111010111011111110111111101011101110111111111110101
100010001000000000100000001000100000100000100000101
101110101111111110101111111110101111101110111011101
101000100000001000101000000010100010100010001000101
101011111111101011101010111010111010101111101110101
101000000010101010001010100000100000101000101000101
101111111010101010111010111111101111101010101011101
100000001000100010001010000010000010001010001000001
101111101110111111101111111011111110111011111011111
100010001000001000101000001000001000001000100000001
111110111011111010101011101110101011111110101111111
100000101010100010001000100010100010000000100010001
101111101010101111111010111011111010111111111110101
101000000000100010001010101000001010000000000000101
101111111011111010111010101111101111101111111011101
100010001010001010100010100010104000100010001000101
101010101110101010101110101010111110111010101111101
101000101000101010001010101000000010100010100000001
101111101011101011101010101111111110111110111111101
100010001010101000100010100010000010100010101000001
111010111010101110101110111010111010101010101011111
100010001000101000101000100010001010001000101000003
101111101011101011111011101011101011111111101111101
101000101010001010000010001010001000001000000000101
101110101010111010101110111110111011111011111110101
101000100010001010101000100000001000001000100010001
101011111111101011101110101111111111101110101011111
101000000000101010001000100010000010001000101000001
101110111110101010111011111010111010111011111011101
100010001000100010101000001010100000100010001010101
111011111010111110101011101010101111101110101010101
101000000010100000100010100010101000001000100010001
101111111110101011101110111110101011111011111110111
100000100010101010001000000010101000100000100010101
101110101010111010111111101010111110111110101010101
100010001000000010000000001010000000000000101000001
111111111111111111111111111111111111111111111111111

L
