111111111111111111111111131111111111111111111111111
101000000000001000100000000010000000000000000000001
101111111110111010101011101110111111111111111011101
100000000010000010001010001000101000000000001010001
111111111010111111111011111011101010101111111010111
100000001010000010001000001010000010101000000010001
101111111011111010111111101011111110101011111111101
100000001010000010100010001004000000101000100010001
101111101010111110101010111110111111111010101110111
100000101010000010101010001000100010001010100010001
101111101011111010101010101011101010101110111011101
101000101010001010101010100000101010100000100000101
101010101010101010101011111111101010111111101110101
101010001010100000101000000010001010001010000010101
101011111011101111101111111010111011101010111011101
101000001000101000001000001010101000001010001000101
101111101110111011111011101010101111111011101110101
101000000010001000100000101010100000100010001010001
111011111011101010111110101010101110101110111011111
100010000000101010001000101000100010001000100000001
101011111111101011101011111111101011111011111110101
101010000000001010001000000000101000001000000010101
101110111111111010111110111110101111101111111010111
100010001000000010000010101000101000100000100010001
111011101111101111111010101011101010101110101110101
100000100000100000100010001000001010101000101000101
101110111110111111101111101111111010111011101011101
101000000010001000100000101010000010001010001000101
101011111011101010111110101010111111101010111111101
101010001010001010000010100010100000101000100000001
101110101110111011111010111110101110101110101111101
101000100010100010001010000000100010100010001000101
101011111010111011101010111111111010111011111010101
100000100010000010001010100000100010100010001010101
101111101111111110111010101110101110101110101010101
101000001000000010000010100010101000101010101010001
101011101010111010111110111010101110101010101011111
101010001010001010001000100010100010101000100010001
101010111011101011101011101110111010101011111111101
101010101000101010001010001010001010101000100000001
101010101110101110111010111011101010101110111110101
101010000010100010001000100000100010101010000000101
101011111110111011101110111110111011101011111111101
101000000010001000101010100010000010001000000000101
101111111011101110101010101011101110111111111011101
101000001000001010001000101000100010100000000010001
101111101111111011111110101110111010101111111110111
100000000000000000000010101010100010101000000000101
111111111111111111111011101010111110101011111111101
100000000000000000000000001000000000100000000000001
111511111111111111111111111111111111111111111111111

L
