111111111111111111111111111111111111111111111111111
101000000010000000000000000000100010000000000000001
101111111010111111111111101011101010101111111111101
100000001010001000000010001010001000100010001000001
111111101011101011111010111110111111111010101110111
100010001000101000001000100010100000001000100010001
101110111011101111101111101010101011111111111011101
100000100000000000100000101000101010000000000010101
101111111111111110111110101111101010111111111110101
100010000000000010000010001000001010000010000000001
111011101111111011111011111011111110111011101111111
101000001000100010000000100010000010101000100010001
101111111110101111111110111010111010101110111011101
100000001000100000001000000010101010000010100000001
101111101011111111101011111110101011111110111111111
100000100010000000101010001000101010000000100000001
111110111110111010101010101011101010111110101111101
100000100000100010101010100010100010100000100000101
101110101111101111101110111110101110111111101111101
101010101000100000100010100000101000000000001000001
101010101011111110111010101110101111101111111011101
101000101000100000101000101010001000100000001010401
101111101110101110101111101011111010111111111010111
100000100010100010000000101000001010000010001010101
101110111010111011111110101110101011111010101010101
101010001000001000100000100000100010001010101010103
101010111111101110111111111111111110111010101010101
501010000000000010001000000000000010001010100010001
101011111111111111101011111111101011101010111111101
100000000000001000101010000010001000101010000010001
111110111111111010101010101110111110101011101011111
100000100000100010101010100010100010001000101000001
101111101110101110101010111010101010111110111110101
100010001010101000001010101010101010100000100010101
111110111010101011111010101010101010101111101011101
100000100000101010100010101010101010101000101010001
101111101111101010101110101010101110101010101010101
100000100000101000101000001010100010100010101010101
111110111110101111101111111010111010111110101010101
100000100000100000001000000010001000100010001000101
101111101111111111101011111011101011101011111111101
101000101000000000100010000010001000101010000000101
101110101110101110111011111110111111101010101111101
100010000010101000100010000000100000001010100000101
101011111011101011111110111110101111111010111110101
101000001000101000000000100000101000001010100010101
101111101110101111111111111111101111101010101010101
101000100010001000000000000000001000101000101010101
101110111011111011111111111111111010101111101010101
100000001000000000000000000000000010000000001010001
111111111111111111111111111111111111111111111111111

R
