111111111111111111111111111111111111111111111111111
100010000010001000000010000010000010000000000010001
111011101010101110111010111011101110111011111010101
100010001000100000101010001000101000101000001000101
101110111111101111101011101110101011101111101111101
100010100010001000101000001000001010000000101000001
111010101010111010101111101111111010111111101111101
100010101010001010100000001000100010000010001000101
101110101011111010111111111010101110111010111010101
301000101000100010000000000010001010100010001010101
101011101110101111111111111111111010101011101010111
101000000010100010000000001000001000101000101010001
101111111010111010111111101011101111101110101011101
100000001010100010000000101010100000101010100010001
111111101010101111111110101010111110101010111110111
100000001010001000001000100010000010001010100010001
101111111011111110101011111111101011111010101011101
100010000000000010101000000000101010000000101010001
111011111111111010101111111110111010111111101110101
101000001000001010100000000000100010100000001000101
101111101011101010111111111111101110101111111011101
101000001010101010000010001000000000001000000010001
101011111010101011101011101011111111111011111110111
100010001010001000101000100010000000100010100000105
101110101010111110111010101110111110101110101111101
101000101010100010001010101010100000101000100000101
101011101010101011101110101010111110101011111110101
101010100010001010000010100010000010001000100000101
101010111111111011111010111111111011111110101111101
101010000000101000001000100000001410000010101000001
101011111010101111101110101111101010111010101010111
100010000010001010001000101000101010001010101010001
111110111111101010111111101010101011101010101111101
101000001000000010100000001010100010001010100010001
101011101011111110111010111010111110111010111010101
101010001010000010001010100010101000001000101000101
101010111110111011101011101110101011101110101111101
100010000000001000101000001000101010100010000010001
111111101111111010101111111011101010111011111010111
100000100010001010100000000010001000100010001010001
101110111010101110111111111110111110101110101011101
100010100010100000000010001010000000100010100010001
101010111110111111111010101010111111111010111110111
101010000010100000101010100010001000100010000010001
101011111010101110101010101111101010101111111111101
101000100000101000100000101000001010001000000000001
101110111111101011111111111011111011101011111111111
100010100000001000001000001010000010001010000000001
111010101111111111101011101010111111111011101111101
100010000000000000100000100010000000000000001000001
111111111111111111111111111111111111111111111111111

U
