111111111111111111131111111111111111111111111111111
100010000010000000000000000010000000100000100000001
111011101110111111111011111011111010111110101111101
101000100010001000100010001010000010040010100000101
101110101011101110101110101010111111111010111110101
101000101000000000100010100010100010100010100000101
101011111011111110111011111010101010101110101111101
100010001010001000001000001000101010101000000000101
101110101010101111111111101111101010101111111011101
101000101010100000000010001000001000100000001010001
101110101010111111111010111110111110111111101110111
101000101010000000100010000010000010000000100010001
101011101111111110101111111010111011111111111010101
101000101000000000100010000010101000000000000010101
101110101011111111111010111110101111111111111111101
100000101000101000000010100010100000100000000000101
111111101110101011111110101010101110111110101110101
100000001000101010001000101010100010100010101010101
101111111011101010101110101110111010101010101010101
100000100010100010101000100010000010001010101000001
111110101110101110101011101011111111111010101111111
100010001000100010101000101000100010000010100000001
101111111010111010101010111010101010111111111111101
100000000010001000101010100010101010000010000000101
111011111111101111101110101110111011111010111110101
100010001000000000101000100010000000001000100010101
101110101111111011101011111011111110111111111010101
100000100000001010001010000010100010100000000010001
101111111111101110111011101110101010101110111111101
100000000000100010000010001000101010100010000000001
111110111110111011111110111010101010111011111111111
100000100010001010000000001010101010100010000000101
111111101011111010111111101010101010101110111110101
100000001010001010001000001010001000101000001000101
101111111010101011101011101111101111101011101110101
100000001010101000001010001000101000001010100010001
101111101010101110111011111010111011111010111011111
100010001000100010001010000010000010000010001000001
111010111111111011111010111111111110111110101111101
100010000000001000100010001000000000000000100000101
101111111111101110101011101110111111111110111110101
101000000000101000001000100010100000100010100010101
101011111010101110111111111010101110101011101011101
101010000010100010100010000010001000101000101000001
101110111110111011101010111111111011101110101111101
100010100000100010001010000010100000100010001000001
111010111011101010111011111010101111111011111011111
100010001010101010100000001010001000001000101010001
101111101010101110101111111011111011101110101010101
100000001000100000100000000000000010000000100000101
111111111111111111111111111115111111111111111111111

R
