111111111111111111111113111111111111111111111111111
101000001000000000001000000000001000001000000000001
101011101010111111111010111111111010111011111111101
100010001010100000000010000000000010000000100000101
111110111110101111111111111111111111111111101110101
100010000010101000000000100000000000100000001000101
101111111010101110111111101111111110101111111011101
101000001010100000100000101000000010101000001000101
101011101010111110101110101111111010101111101110101
100010001010000010101000100010000010001000000010001
101110101010111010101011111010111111111010111111101
100010101010001000101010000010100000000010100000101
111010111010111111101011101110101011101111101110101
100010000010100000001000101000001000101040001010101
101111111111101111111110101011111110111011111010101
101000001000001000000010101000000010001010000010101
101110101011111011111110101111111011101011101010101
101000100010000010000000100000101010001000101010001
101011111110101010111111101110101010111110111011111
100010000000101010000000101010100010000010000000001
111111111111101011111110101010111110101111111111101
100000000010001000001010100010000010100000001000001
101011111010111111101010111111111011111011111011111
101010000010100000000010000000001000001000000010001
111010111110101111111111111111101111101011111110111
100010000010100000001000000000101000001010000010001
101111111010111011111011111110101011111010101110101
100010000010100010000010001010001000100010100000101
101011111010101110111110101011111110101110111111101
101000001000100010000010100000000000101010100010001
101111101111101111111010111111111111101010111010101
101000100000101000000010000000100000001000000010101
101010111110111011111111111110111111101111111010111
101010000010001010000000000010001000100000100010001
101011111011101010111110111011101010111110101111101
101000001000001010000010001000001010001000101010001
111111101111101011111011101111111011101011101010101
100010001000001010001000100000000000101010000010101
101010111111111010101110111111111111101011111010101
101000100010001010101000100000001000001000001010101
101111101010101010101011111111101011111111101010101
100000001000101000101000000000001010000000001010101
101111111111101111101111101111101010111111111110101
101010001000100000100000101000101010000010000000101
101010101010101111111110111010111011111010111111101
101000100010100000000000100010001000100010000010101
101011111110111111111111101111101110101111111010101
101000100010000000000000101000101000100000000010001
101111101011111110111110101010101011111111111110111
100000001000000000100000001010000010000000000000001
111111111111111111111111111111111111111111151111111

L
