111111111111111111111111111111111111111111111111111
100010001000100000100000000000000010000000000000101
111010101010101110101110111111111010111111111110101
100010101010100010100010100000001010000000101000101
101110101010111010111010111110101011101110101011101
101000100010001010000010000010101000100010100000101
101011111111101011111111111010111110111110111110101
101010000010001010000010001010000000100010100010101
101011101110111010111010101010111111101010101010101
101000001000100010001000101010100000001010101010001
101111111011101111101110111010111111101010101011111
100010000010001000001000100010100000001010001010001
111010111110111110111111101110101111111010111010101
100010000010000010100010001010001000001010001000101
101110111011111010101010111011111011101011101111101
101000101000100010101000100000100010100010001000001
101110101110101110101111111110101110111111111011101
300010000010101000101000000010100010000000001010101
111011111110101011101011111010111011111010101010101
101004000010101010001010100010000010001010101010001
101111111010101010101010101111111010101010101010111
100000000010101010101010100000001000101010100010001
101111111110101010101010111111101111101010111111101
101010000000001010101010000000100000101010001000101
101010111111101010101010101011111110101111101011101
101000100000100010101010101010000000100010001010001
101110101110111110111011101110111111111010111010111
100010100010000000100000001000101000001010001000105
111010111011111011101111111011101010111011101011101
101010001000001010000010000010100010001000001000001
101011111011101110111110111110101111101111111111101
101000001000100000101000100010001000000000101000101
101111101111101111101011101010111011111110101010101
100000100000100000001000001010101000000010001010001
101110111110111011111111101010101111111011101011111
100010001010001010000000101010000010001000101010001
101011101011101010111110111011111010101110101010101
101000100010001010100010000010001010100010101010101
101110111010111110111011111110111010111010111011101
100010100010100000100000000010000010100010001000001
111110101110101111101110111110111111101111101111101
100010101000101000000010100000100000001000000000101
101010101011101111101010101111111110101010111111101
101010101010001000101010101000000000101010100000001
101010111011101010111010101011101111111010101111111
101000100010001010000010101000101000100010100010001
101111101110111011111111101110111010101111111010101
100000101000100010000000100010100010001000100010101
101110101011101110111110111010101111111010101111101
100010000010000000000010000000100000000010000000001
111111111111111111111111111111111111111111111111111

R
