111111111111111111111111111111111111111111111111111
100010000000100000000010000010000000000000000000001
111010111011101111101010111011111111101111111111101
100010001000001010001010100010000000001000000010001
101110111110111010111010111010111111111011101110111
101000100010000010100010001000100010000000101000101
101110101011111110101110101111101110111110101011101
100010101000000000100010101000100000001000101000001
111011101111111111111010101010101111111011101111101
101000001000000010100010101010100010000010001000101
101111111010111010101111101010111010101111111010101
100010000010001000101000001010001010101000001010001
101110111111101111101011111011101110111011101011111
101000001000101000100010000010100000100010001010001
101011111010101010111110111110111011101110111010101
100010100010100010001000000010000010001010000010101
101110101110111110101011111011111110111011111110101
100000101010000010101000001000000000100000001010101
111011101011111011101111101111111111111011101010101
101010001000100010001000101000000000000010101000101
101010111110101110101110101111101111111110101111101
100010100000100000100000100000100010001000000000001
111110111011101111101111111110101010101011111111101
100000100010001000101000000000101010100000001000101
101111101110111010111011111111101010111111111010111
101000100000100010001000100000101010100000000010001
101010111111101111101110101011101011101111111111101
100010001000001000100010101000001010001010000010001
111111101011111010111010101111111010111010111010101
100000001010000010001000100000100010100010100010101
101110111011101111101111111110101010101110101110101
101010100010001000101000000010101010101000100000103
101010101110111010101110111010101010101011111111101
101000101000001010100010100010101010001000001000101
101111101011101011111010101110101111101111101010101
100000001010001000000010101000100010001000100010101
101111111110111011111110101111101010111011111110101
100000001000101010100000100000101010001000100000101
111111101011101010101011111110101011101010101111111
101000001010000010001010001000101000101010100000001
101011111010111111111011101011101011101110111111101
100010000010000000100010001010101000000000100000001
101110111111111110101110111010101111111111101111101
101000001000100000101000001010000010001000001000101
101111101110101111101011101011111010101011111011101
500000101000100010001000101000100010101010100010001
111110101011111010111110101110111114101010101010111
100010001000100010001000100010100010100010001000101
101111111010101111101011111010101010111110111111101
100000000010000000001000001000001000100000000000001
111111111111111111111111111111111111111111111111111

D
