111111111111111111111111111111111111111111111111111
101000100000100000000000100010000000000010000000101
101110101010101111111010101011111011111010111110101
100010001010100010001010001000000010100010000010101
111011111010111110101011111111111110101111111010101
100010000010100010100010000010000010001000000010001
101110111110101010111110111010111010111011111111101
100000100010101000100000100010100010100010000000001
111111101110101111111011101110101110101010111111111
100010000010101000000010001000100000101010100010001
101110111010101011111011111011111111111010101010101
100010100010001000100010001010000000000010001000101
111010101111111110101110101010111111111110111111101
100010100000100000101010100010001000000000100000101
101110111011101011101010111110101111101111101110111
100000101000001010001010000010101000100000101010001
101111101111111011101011111010101010111110101011101
101000001000001000101000001010101010100010100010001
101011101011101110101111101011101010101011101110101
100010001000101000100000001000101010101000001000101
111110111010111011111111111110101010101111111011101
100010100010001010001000000000100010000010001010101
111010101111101010101011111111111111111011101010101
100010100010001000101010000000001000001000101010101
101110111110111111101010111110101011101110101010101
300010000010000000101010100000100010000010001010001
101011111011111010101011101111111011111011101011111
101010001000000010100010001000000010001010101000001
101010101111111110111110111011111110101010101111101
101000100010000010100000100010000000101010101010001
101111101110111010101011111110111111101010101010101
100010001000101010101010000000000010041010000010101
101110101011101010101110111111111110111011111010111
101000101000101000101000100000001000101000100010001
111011101110101111101011101111101011101110111011101
100010100010100000000010001000101010000010001000101
101110111010111110111110111110101011101111101110101
101000100010000010000010100000101000100000100010105
101110101111111011111010101010101110111110111010101
101000100000001000001010101010100000100000100010101
101011101111111111101010101011111111101110101111101
101000001000000000001010101000001000001000100010001
101111111011111111111010111111101010111110111010111
101000001000100000100010001000100010100010100010001
101011101110101110111111101010101110101011101111101
100010100010001000100000101010101010001000100000001
101110111011111011101110101010101011111110111111101
101000100010000010001010100010101000000010000000101
101010101110111110111010111110101110111011111110101
100010100000000000100000000000100000100000000010001
111111111111111111111111111111111111111111111111111

U
