111111111111111111111111111111111111111111111111111
100010000000000000000000000000001000000000000000101
111011101111111111101011111111101111101111111010101
101000100000100000101000000000100000101000001010001
101110111111101110101111111110111110111011101011101
100010100000001000100000100010000010001000101000101
101110101111111011111111101010111011101110101110101
100000100010001000100000001010001010000000100000101
101111111010111110101111111011101011111111111111101
101000000010100000101000001000101000000000001000101
101011101110101111101011101110111110111111101011101
101000101000001000001010000010000010100000001000001
101111101011111011101110111011111011101111111011111
100000101000001000100010001000101000001000001000001
111110101111101111111010101110101111111110111111101
100010001010001000000010100010000000000000100000001
101111111010111011111110111011111111111110101111111
100010000010001010000000001010000010000010101000101
101010101111101011111111111010111010111010101010101
101000100000101000100000001000001010001010100010101
101111111110101010101111101111101011101010111110101
100010000010001010100000100000101000001010000010001
111011101111111110111110111110101111111011111111101
101000100000000010000000001000100000101000100000001
101110111110111011111111111011111110101110101111111
300000100000101010000000000010000010100010100010001
101111101111101010111111111110101010111010101110101
100000001000100010100000000010101010001010001000105
111111111011101110101011111010101111101011111011101
100010000000001000101010000010101000100000101010101
101110111111111011111010111110101010111110101010101
100010001000100000001010000010101010000000001010101
111011101110101111101011111110101011111111111010101
100010101000100010001000100010100010100010001000101
101010101011111010111010101010111110101010101110101
101000101000001010100010101010100000101010100000101
101011101011101010111110101010111010101010111111101
101010001010001010000010001000001010101010100000101
101010111010111011111010111111101011101010101110101
101010001010000000001010100000100010001010100010101
101111101011111111111011101110111110111010111010101
101000001000100000001000000010000000100010001010101
101011111011101111101011111111111111101110111010101
100010000010001000101000100000000000100000140010001
101111111010111010101110101111111110101111101111101
100000001010100010101000100010100010100010001000001
111111101110101110101111111010101010111010111011111
100000100000101000101000100010101010100010100010001
101110111111101011101010101110101010111110101110101
100010000000001000000010001000001000000000100000101
111111111111111111111111111111111111111111111111111

R
