111111111111111111111111111113111111111111111111111
101000000010000000100000100000000000100000000000001
101111101110111110101110101110111110101111111111101
100000100010100010001010100010001000100000101000101
111110111010101011111010111011101011111110101010101
100010001010001000000010001010101010100010101010001
101111101011111111111010101010101010101010101011101
100000101000001000100010101000101000101000101000101
101110101110101110101110111110101111101111101110111
101010001000100000101010000010100000001000100010001
101011111011111111101011111010111111111010101111101
101000100010000000001000001010100000000010100000101
101010111010111111111110101010101011111110111010101
101010000010000010000000101000101010000010001010101
101011111011111010101111101111111010111111101010101
101000100000001010101000000000000010001000001010101
101010111111101011101111111111101111101011111011101
101010001000101000100010000010001000100000100010001
101011101010101110111010111011111010111110101110101
101000101010000010100010001000100010000010101000101
101110101111111110101111101110101111111010101011101
101000100010000010001000001000001000100010001000101
101110111010111011101011111111111010101111111110101
100010001000001000001000100000100010100000100000101
111011111111111111111110101110101011111110101111101
101000000010000000000010000010101000000010100010101
101111111010111111111011111110101110111110101010101
101000001000100000001000001000100010100010101010001
101010111111101010111111101011101110101010101010111
101010000000101010100000100010101000101000101010101
101011101111101011101110111110101010101111111010101
101010100000101000001010000010001010100000100010101
101010111110101111111011111010111010111110101110101
100000000010100010000000101000001010000010001010101
111111101110111010111110101111111011111011111010101
100000101000100010100010100000100010100010000010101
101110111010101110101010111011101110101111101110101
100010001010101000001010000010001000000000001000101
111011101010101111111011111110111111111111101011101
100010100010100000001000000010000000100010001010001
101110111110111111101011111011111110101011101011101
101000000010100000101010000010000010101000101000001
101110101110111011101010111011111010101110111111101
100010100010001000101010101010000010101010000000001
111010111011101110101110101010111010101011111111111
100010001000100000100000101000101010100010001000001
101111111110101111111111101111101010111410101011101
100000100010001000001000000010000010001010101000101
101110101011111011101011111010111110111010101110101
100010001000000000100000001000000010000000100000101
111111111111111111111111111111111511111111111111111

D
