111111111111111111111511111111111111111111111111111
100000100000000000100000000010000000001000000000001
111110101110111111101011111110111110101110111111101
101000100010000000001000000010101000100000100000001
101011111110111111111111111010101011111111101111111
100010000010000000100010000010101000000010001000001
101111101011111110101110111110101111111011111011101
100000001010000000001000100010100000001000100010001
111111111011111111111011101010101111101110101110101
100000101010000010001000001000101000000010000010101
101010101010111010101011111111101111111111111110111
101010001010001000101000100000001000000000000010001
101011101011101111101110101111111011111111111010101
101000101000001000001000101000000010000000101010101
101110111111111011111011101011111110101110101010101
100010000000100010001010001000100000100010001010101
101111111010101110111010101110101111111010111010101
101000001010101000000010101000101000001010100010101
111011101011101111101110111011101010111011101111101
100010000010001000100010100010001010001000100000001
101111111010111010111010101110111011101110111111101
100000001010100010001000100010001010000010000000101
111111101110101111101011111011101110101111111011101
100000101000100000101010001000100000101000001000101
101110101011101110101110101110111111101011101010101
101010001000101000101000100000100000001010001010001
101011101110101011101011111011111011111010111111101
101000101010101000100010000010001010000010001000101
101110101010101110111110111110101110111111101010111
100010100010100010000010101000100000100000100010001
111010111010111011111010101011111111101110111111101
100010000010100010001010001010000000001010001000001
101111111110101111101011111010111111111011101011101
100000000000100000001000000010001000000000101010001
101111111111101111101111111111101110111111101010111
100010000000101000100010000000100010000000101010001
111011101110111010111010111110111011111110101011101
100010001010000010100010100000101000000010101010101
101110111011111110101110101111101111111010101010101
101000100000100010100000100010001000001010001010001
101011111010101010111011111010101111101010111011111
100010000010101000100010001000101000101010001000001
111110111111101111101110101111101010101011101011101
100000100000100010001000101000100010001010001010001
101110101110111010111011101010101111111010111110111
100010100010000010100010001010101000000010000010401
111010111011111111101110111010111011111111111011101
101010000010000000001010100010001010001000001000101
101011111110111111111010111011101010101011101110101
100000000000100000000000000010000010100000100000001
111111111111111111111111111111111113111111111111111

L
