111111111111111111111111111111111111111111111111111
101000100000001000000000001000000000100000001000001
101010101011101110111111101011111110111111101010111
101010001000100000100000100010000010100000001010001
101111111110111111111010111110111110101111111011101
100010000010100000001010001000000000100010001010101
111010111010111010101011111011111111111010101010101
100010101010001010100010001000000000001000101000101
101110101010101110111010101111111111101011101011101
301000100010100410001010100000000010101010100010001
101011101111111010101110101111111010101010111110101
100010101000000010100000101000001000101000001000101
111110101110111111111111101011101110101111111011101
100000100000100000000000001000100010101000001000101
111010111111111011111111111010111010101011101010111
100010000000000010100000001010100010100010001010001
101111111111111110101110101010111110111110111011101
100010000000000010001010101010100000100010001000101
101010111111111010111010111010101111101011101110101
101010000000001010000010100010001000001010101000101
111010111111101111111010101111111110111010101111101
100010000000100000000010001010000000100010101000101
101011111110111111111111111010111011101110101010101
101010000010100000100000001000100010001000101010001
101110111010101110101111101110101110111110101011101
100010001010001010100000100010101010001000100010001
111011101011111010111110111011101011101010111110111
100010001010000000100000101000001000100010001010101
101010111011101111101111101111111110111111101010101
101010101000101000001000100010000000001000101010105
101010101110101011111011101010101111111010101010101
101010001000101000001000001000100010000010000010001
101111101011101110101111111111101010111111111011101
100000101000100010100000001000101000100000101010001
101110101110111010111111101010111011101110101010111
101010001000100010001000001010001010100010100010001
101011111011101111101011111011101010111010111111101
100010001010000010001000000000101000100010100000001
111010101011111011111111111111101110101110101111111
100010101000100010000010000000001000100010101000101
101110111110111010111010111111111011111010101010101
100000100010001000101010100010000010000010101010101
111011101011101111101010101010111110111110101010101
100010001000001000100000101000100010000010100010001
101110101111111110101111111111101011111010111111101
101000101000100000100010000010001000100010000000101
101011111010101011111010111010111110101110111111101
101010001010101000000010001010101000100010000000001
101010101010111111111111101010101011111011111111111
101000100010000000000000001000001000000000000000001
111111111111111111111111111111111111111111111111111

L
