111111111111111111111111111111111111111111111111111
100000000010000010001000001000000010001000000000101
111111111011101011101010111010111010101011111110101
100000001000001010001010000010101000101010000010101
101111101111111010101011111110101111101010111010101
101000100010000010101000100010100000000010101010101
101110111010111110101110101010111111111010101010101
101000001000101000101000101010100000001010001010001
101011111111101010101011101010101111101111101011101
101000100010001010101010001010001000101000101000101
101110101010101010111011101111111010101010101110111
100010101010100010001000100000000010101010101010001
111010101010111111101110111111111110101010101011101
300010101000100000000010100000000010100010000000101
101110101111101011111110101111111010111111111110101
100010000000101010000000101000001010000000100010101
111011111111101010111111101011101010101111101011101
101010000000101010000010001010001000101000101000101
101010111110101011111010101010111111111010101110101
101000100010101010001000101010000010001010001000001
101111101010101110101111101011111010101011111111111
100000101010100000101000001010001000101000000000001
101010101110111110101011111010101111101111101111101
101010001000100010100000100010100000100000101000001
101010111011101011101111101110111110111110111011101
101010100010001000101000001010100010000010001000105
111010101110111110111011111010101011111011101110101
100010101000000010100010000010101000101000100000101
101110101110111010101011111010101110101110111111101
100010100010001010001010001000001000101000000000101
111010111011111011101110101011111110101011111011101
100010001000001000101000101000100010001010000010001
101111101111101010111011101111101010111010111110111
101010000000101010000010100000101010100010000010101
101010111111101011111110111110101011101110111110101
101000001000001010000000000010001010001000100000101
101111101011111010101111111011111010111011101111101
101000101000101010101000100000100010100010100000001
101010111110101010111010111011101110111010111111101
101010000010100000100010001010001000001010001010001
101011111010111111101111101110111011101010101010111
101010001000100000001010001000100010001000101010001
101010101111101111111010111011111110111111101011101
140010100010000010000010001000000010000010000000101
101111101011101011101011101011111010111011111111101
100000101000101000101000101010000010101000100000101
111110101110101110111110101110111110101110101110101
101000101010100010001000100010000010100010101000101
101011101010111111101011111011111010111010101011101
100000001000000000001000000000000010000010001000001
111111111111111111111111111111111111111111111111111

D
