111111111111111111111111111111111111111111111111111
301000000010000000000010000000000000000010000000001
101010111110111011111010111111101111111011111011101
101010000000100010001010000000101010000000001010001
101111111111101110111011111110101010111111101010101
100000000000100010001000401000101000100010001010101
111111111110101011101111101111101111101010111110101
100000100000101000100000000000100000001010000000101
111110101111111110111111111110101111111011111011111
100010100000000010000000100000100010000010000010001
101010111111111011111110111110111110111011111010101
101000000010001000000010000010100010100010001010101
101111111010101111111011111010101010111110101110101
100000001010100000100010000010001010100000101000101
101111101010111010101110111111111010101111101011101
100000101010100010101000100000100010000000100000101
111110101011101110101011101111101111111111101111101
100010101000001010101010100000101000001000101000001
101010101011111010101010101110101010101010111011111
101010101010001000100010000010101010101010001000001
101010101110101011111110111110101110101011101011101
101010100010101000000010101000100000100010001000101
101110111010101111111010101011111111111110111111101
100000101000100010000010101010000000100000100000001
101111101111111011111110101010111011101111101111101
101000000000001000000000101000100010001000001000101
101011101111111111111111101111101110111111101010101
101010001000000000001000001000001000100010001010101
101011101011111011101111101011111011101010111011101
101000101010001010101000101000100010001000101000001
101010111010111010101010101110101110101111101011111
101010000010100010100010100010001000101000001010005
101110111110101110111110101011111011101010101010101
100010100000101000100000101000001010101010101000101
111010111011101010101111111111101010101110111111101
101010000010001010001000000000001000100010000000101
101011111010111011111110101111111011111011111011101
100010100010001010000010100010000010001000100010001
101110101111101011101011111010111110101110101110111
100010001000001000001000100010100010100000100010101
111011111011111111111110101110111010111111111010101
101000001000100000001000100000000010001010000010101
101111101010111011101011101111111110101010101110101
100000001010100010001010101000000010101000101000101
101111111110101110111010101011111011101011101011101
100010000000101000001010001010001000001010001010001
111010111111101111111011111010101111111010101010111
100010100000001000100010001010101000001010101010001
101110101111101010101110101010111010111010111011101
100000100000100010000000100010000010000010000000001
111111111111111111111111111111111111111111111111111

R
