111111111111111111111111111111111111111111111111111
101010000000001000000000000010001000100000001000001
101010111011101011111111111011101010101111101010101
101000001010000010000010001000001010001000100010103
101111111010111110111010101011111011111010111110101
101000000010100010001000100010000010000010100010101
101011111111101011111111101110111111111110101010101
101000000000001000000000101000100000000000101000101
101111111110111111111110101011111011111110101111111
100000100010000000000010101010001010000000100000001
111110101011111011111110101010101011111110111111101
100010001010000010001000101010101000000010101000001
111011111011111110101011111010101111111010101011111
500010001000000000101000000010100010000010001000001
101010101111111111101011111110111010111111101111101
101000101000001000101000000000101010001000001000101
101111111011101010101011111111101011101011111010101
100000001000101010001010001000100000001000100010141
101111101110101011111110101010111111101111101110101
100000100000100010001000101010001000101000100010001
111110111111111110101011101011101010111010111011101
100010001000000010101010001010101010001010100010101
101011101011111010101010111010101011101010101110101
101000101010000000100010000010101010001010001000101
101111101011111111111111111110101010111011111010101
101000001010001000000010000000001010001000101010001
101011111010101111101010111111111011101010101011111
100010000000101000101010000000100010001010100000101
101110111111101010101011111110101111101110111110101
100010000000101010001010000000100000100010000010101
111011101111101011101110111111101110111010111010101
101010001000101000101000100000001000101010001010001
101011101010101010111011111011111011101011101011101
101000101010001010000000001010001010001000101000101
101110111011111111111111101110101010111110101110111
100010001000000000000010000000100010000000100010001
101111101011111111111011111111111110111111111111101
101000101010000010001010000000100000000000100000101
101010101011101010101010111110111111111110101110101
101010001000001000101000000010001000100000101000001
101011111110111111111111111011101010101111101111101
101010001000100000001000100000100010101000000000101
101011101011101111101010111111111110101111111110101
100010001010001010001010001000000000100000001000101
101110111010111010111011101010111111111111101011101
100010000010100010001000100010100000001000100010001
111010111110101011101110111111101111101010111110111
100010100010101000100010000000000000101010000000101
101111101010101110111011111111111111101011111111101
100000001000100010000000000000000000001000000000001
111111111111111111111111111111111111111111111111111

D
