111111111111111111111113111111111111111111111111111
101000000010000000000000001000000000001000001000001
101010111110111111111110111011111111101011101010101
101010001000100000001000100010000010001010100010101
101110101011101111101011101110111010101010111110111
100010100010001000001000000010001010101010000010001
111010111110111011111011111011111010111010101011101
101010000010101010001010001000001010000010101000101
101011101110101010111010101111101011111111101111101
101010001000100010000010101000001000000000001000101
101011111011101111111110101011111011111011101010101
101000001000101000001000101010001010001010001010001
101111101110101011101011101010101010101010111011111
100000100010100010100010001010101010100010101000001
101110111010111110111110111010101110111110101111101
100010001000100000000010100000100000100010001000101
111010111111111011111010111111111111111011101010101
100010100000000010000010000000000010001000000010101
101111101011111111101111111111111010101111111011101
100000101010000000100000100000001000100000001010001
101110101010111110111110111110101111111111101110101
101000101000001000100010001000100010100000100010101
111010101111111011101011101011111010101110111010101
100010101000001000101000100010000000101010001010101
101111101011101110101110101111101111101011101010111
101000001000100000140010101000101000001010001010001
101011111110111110111010111010111011111010101011101
100010000010001000100010000010000010000010101000101
111110111011101011101111111111111110111010111110101
100000100000001010001000000010100000100010000010101
101111101111111010111111101010101111101111101110101
101000001000001010001000101010001000100000100010001
101111111011101111101010101011101010111110111011101
100000000010100000100010001000101010000000100010001
101111111110111110111111111110111011111110101010111
100000001000000010000000100010001010001000101010001
111111101011111011111011101011101010101011101111101
100010001010000000101000001000101010101010100000101
101010111010111110101111111011101010111010111110101
101010100010100000001000001000100010000010100010001
101110101110111111101110111110111110111110101011111
101000101000100000100010000010000000100000101000001
101011111011101110111010111011111111101111101110101
101000001000001000101010101000000000001000001000101
101111101111111011101010101111111011101011111011101
101000100010001010001010001000001000100010000010101
101010111010101010101011111011101110111110111110101
101010001000101010101000001010001000001000101000001
101010111111101010111111101010111111111011101011111
100010000000000010000000000010000000000010000000001
111111111115111111111111111111111111111111111111111

R
