111111111111151111111111111111111111111111111111111
100010000000000000100000000010000000000000100000001
111011111110111110111011111011111110101110111111101
101000100010100010000010001000000010101000000000101
101110101010101011111110101111111011101111111110101
100010001010001000000000100010000000100000000010101
101111111011111111111111101011111110111111101010101
100000001000100000001000101000100010000000101010001
111110111110101111101010111010101011111110111011101
100000100000100010100010001010001000001010001000101
101110101111101010111111101011111110101011101110101
101000101000001010000000101000100010101010001000101
101110101011111010101111101011101011101010111011111
100010101010001010101000001010001000001000100000001
101010101010101010111011111110111111111011111111101
101010101000101010001000100010100000000000000000101
101011101111101011101110101010101111111111111110101
101010001000001000100010001010101000000010001000101
101010111111111110101111111010111011111010101011101
101000100000000010100000100010000010000010101010001
101111101111111010111011101111111110111110101011101
100000101000000010001000001000000010000010101000001
111110101011111111101011111011111010111010111111101
100000101010000010001000000010001010100010001000101
101111101011101010111111111110101011101110101010101
101000001010001000100010000000101000100010100010101
101110101010111111101010111110111110101011111010101
100010101000101000001000101000100000101000001010001
111010101111101011111111101011101111111011101011111
100010101000100010100000001000100000001000101010001
101110101110101110101011101110111111101111101010101
101000101000100010101000100010000000100000001000101
101111101011111010101110111011101110111111111111101
100000001000001010001000101010100010100000000000101
111111111010101010111011101010111010101110101111101
100000100010101010001000100010001010101010101000001
111011101110101011101110101111101011101010111011111
100010001010101010001000101000001000100010001000101
101010111010111011111011101011101110111011101110101
101010001010000010001010100010000010001000100000101
101111101011111110101010111110111110101110111111101
101000101000000000100010001000100000100010100010001
101010101110101111111110111011101110111110101010101
100010100010101010000010001000100010100010001000101
101110111011101010111010101011111010101011111111101
100010000010001000001000101010040010101000000000101
111011111110111111111111101010111110101110111111101
100010000010000000000000101010100000101000100000001
101110111011111111111110101010111111101011101111111
100000100000000000000000100010000000001000000000001
111111111111111111111113111111111111111111111111111

L
