111111111111111111111111111111111111111111111111111
100000100000000010000000000000101000001000000000001
111110111111101010101111111110101011101010111111101
100010000000101000101000001000100000100010001000101
101111111110101111101010111011111111111111101010101
101000100000100000101010001010000000001000001010101
101010101111111110101111101010101111101011111010101
101010100000001000101000101010100010001010100010101
101010111111101011101010101011111010111010101011101
100010000000101010001010101000100010000010001000001
111110111111101010111010101110101111111110111111111
100000100000001010100010000010001000100010000000001
101110101111111010101111111011111010101111111111101
100010100010000010101000001010000010100000000000101
111010111010111110101011101011101110111011111110101
100010001010000010101010101000001010000010100000101
101011111011111010101010101111111011111110101111101
101010000010000010101010100010001010000000101010001
101010111111111010101010101010101010111010101010111
101010100000001010101000101000100010001010101010001
101010111011101010101111101111111110111010101011101
101010000010101010101000100000100000100010101010005
101111111110101010101010111110101111101110101010111
101000000010101010100010000010000010001000101010101
101011101010101110101111111011111110111110101010101
100010001000101000101000001010000010000010100010001
101110111110101011101011101010111011111010111011101
101000100010101010001010001010100010000010001010001
101011101110101010111110101010101110111011111010111
101000100000100010100010101000100010001010000010001
101110111111111110101010101111111011101110111111101
101000100000000010001000100010001000100000000000101
101010101110111111111111111010111110101111111111101
101010101010000000000004000000100010101000000010001
101010101011111111111111111111101010111011111010111
101010101000001000000000100010001000100010001010001
101010101110111011111110101010101111101110111011101
101010101000100010000010001000101000101000100000101
101010101010101110101111111111101010101010101111101
101010101010101000101000000010001010001010100000101
111011101011101011101011111010111011111010111110101
100010001010001000100010001000100010001010100010001
101110111010111110111110101111101110111010101011111
300010000010100000100010100000100010000010101000001
111011111010111111101010111110111011111110101011111
100000100010000000101000100010001000100010001000001
101110101111111110101111111010111110101011111111101
100010101000001010001000001010100010001010000000001
101011101011101011111011101010101011111010111111101
101000000010000000000010000010001000000000100000001
111111111111111111111111111111111111111111111111111

R
