111111111111111111111111111111111111111111111111111
100000000010000010000000000000100000001000101000001
111111111011101011111110111110101111101010101011101
100000000010001000000000100010100000100010100000101
101111111110111111111111101010111010111110111111101
101000000010100000100000001010001010001010000000001
101011111010101011101011111011101111101011111111101
500010001010101000101000100000101000101010000000101
111110111010101110101110111111101010101010101111101
101000001000100010100010100000001010001010100000003
101011101111111010111010101111111011111010111111111
101010000010001010001010101000100000100010001000101
101010111010101110101010101010101110101111101010101
100010101000101000101010100010100010100000100010101
101110101111101011101010111110111010111110111110101
100010101000100010001010000000101010001000000010001
111010101010111110111011111111101011101011111011101
100010101010100010101000000010001010101010001000101
101110101010101010101111111010101010101010101111101
100010101010001000000000001010101010101000100000001
101110101011111111111111111010101010101111111110111
101000100010000000000000001010100000100000100010001
101011101110111111111111101011101111111110101011101
101010101010100000100000001000101000000010001010001
111010101010111110101111101110111011111011111010111
100010000010000010101010000010000010001000100010001
101111111111111010101010111111111110101110101111101
100000000000001000101000001000001000100000100000101
101111111110101110101111111010111011111111111110111
101000000000101000100000000010001010000000000010001
101011111111111011111111111111101010111110111011101
101000100000100010000000000010100010000010101000001
111110101110101110111110101010111111111110101111101
100010000010100010100010101000000000000000100000101
101011111010111011101011101011111111111111101011101
101000100010001000101000101010000000100010001010001
101110111110101110101110101110111110101010111010111
100010000000100010001010100000101000101010001010101
101011111111111011111010101111101011101011111010101
101000100000100010100000100000101000001000001010001
111110101011101110101111111110101111111111101011101
100000101000101000100010000010001000001000101000101
101111111110101010111010101011101010111010101010101
100000100010000010100010101010001010100010001010101
111110101011111111101110101110111110101111111010101
100000101010000000001010100000000000100040100010101
101111101010111111111010111111111111111110111110101
100000101000100010001000100000000000000010000010001
101110101111101010101111101111111111111011111010111
100010000000001000100000001000000000000000000010001
111111111111111111111111111111111111111111111111111

R
