111111111111111111151111111111111111111111111111111
100010000000100000100000001000001000100000000000101
111010111011101011101111101010101010111111101110101
100010001000001000101000100010100010100010001000101
101111101111111110101010111110111110101010111011101
100010001000100010000010000010001010101000101010001
111010111010101011111111111011101010101111101010101
100010000010101010000000001000101010001000001000101
101111111111101010111111101111101011111011111111101
101000001000001000100000101000001000100000000000101
101110101011111111101110101011111011101111111110101
100010101010000000100010001000001000001000100010101
111010101011111011111011111111101011111010101010101
101000100010001010001010000000101000000010101010001
101111111110101010101011101110101111111110101111111
100000000000101010101000100010101000001010100000001
101111111110101010101110111010101011101010101111101
100000100010101000100010001010100010001010100010001
101111101010101111101111101010111110111010111010101
101000001000100000100000100010000000100010001010101
101011111111111110111011111111111111101011101110101
101000001000000010100010001000100000001010001000101
111111101011111110101110101010101110101110111011101
100010001010000010100000101010001000101000100010001
101010111010111010101111101011111011101011101110111
101010001000101000101000100010000010001010001000001
101011101011101111111010111110101111111011101111101
101000001000000010000010001000101000001000100000101
101111111111111010111111101011101011101110111110101
100010001000001000101000100010001010100010100010101
101010101010101111101010111110111010111010101010111
101000101010100000001010000000001000101000101010001
101111101010111110111011111111111110101111101011101
101000001010000010100010001000000010100000001010001
101011111110111011101111101011111010101011111010111
101000000010101000000000001000001000101000001010001
101111111010101111111111111111101111111110101011101
100010000010001000000010001000001000000010101010001
111110111111101011111010101011111011101011101010101
100010100010001000100010100010001010101000001000101
101010111010111110101110111110101010101111111111101
101010001000100010100400100000101010100010000000101
101011101011101010111111101111101010111010101111101
101000001000101010100010001000001000001010100010001
101011111110101010101010111111111110111010111010111
101010001000001010001010100000000000100010100010001
101110101111111111111010101111111111101110101111101
100000100000000000001010001000000010001000101000101
101111111111111011111011111011111010111011101010101
100000000000001000000000000010000000100000100010001
111111111113111111111111111111111111111111111111111

R
