111111111111151111111111111111111111111111111111111
100010000000001000000000000000100000000000000000001
111011101111101011111110111111101111111111101110101
100010001010001010000000100000101000100000101000101
101110111010111010111111101110101010101110111011101
100010001000100010001000100010000010101010100010001
111011101011111011101010101111111011101010101011111
101000001010001010100010001000100010001010001010001
101111111010101010111110111010111110111011101110101
100000100010101000100010100010000000101000001000101
101110101110101111101011101111111111101011111011101
100010001000100000001000100010000000000010000010001
111011111011111111111110111010111111111110111110101
100010000000001000100010001010100010000010100010101
101111101111101011101011101011101010111010101010111
100000101000101000001000101000001000001000001010001
111110101010101011111011101111111111111111111111101
100000101010001000001010001000000000000000000000101
101111111011111011111010111011111111111111111110101
101000000010001010001010001010100000001000000000101
101111101010101110101011101010101110101011111111101
100010001010100000101000101010001000101010000000001
111010111110111111101011101010111011111011111110101
101010100000100000001000100010001010001010000010101
101010101111101111111010111110111010101010111011101
100010001000100000101010000010100010100010001000101
101111111010111110101010101110101110111111101110101
100000000010100000100010101000100010100000001010001
111111111110101111101110111011111010101011111011101
100000000000100010000010000010001000101010100000101
101111111111101011111011111111101111111010101110101
101000001000001000101000100000001000000010000010001
101110101011111110101110101111101011101111111011111
100010100000000010100010001000141010100000101010001
111010111111111010101111111110101010111110101010101
100010100010000010100000000000101010100000101000101
101111101010111110111011101111101010101111101111101
100000001010001010001010001000101000101000000000101
111111111011101011101011111010101110101010111111101
100000000010000000101000000010100010101010001000001
101111111111101111101111101110111010101011101011111
100010100000101000100000100010001010101010100010001
111010101010111010101110111110111011101010111111101
101010001010000010100010000010000000101010000000001
101011111011111110111111101011111110101011101110101
101000000010000010100000101000001000101000100010101
101111111110111110101110111110101011101110111110111
101000000010000010100010000010101000101010100010001
101011101110111010111011111011101110101010101011101
100000100000001000000010000000001000001000001000001
111111111111111111111111111111111111111311111111111

U
