111111111111111111111511111111111111111111111111111
100010000010000010001000000010000000000000001000001
111010111010111010101011101011101111111110111010111
100010101000101000101010001000100000000010000010001
101110101111101111101110111110111111111011111011101
100010100000100000100010001010100010000010001000101
111010111110101011111011101010101011101110101111101
100010000010001000001010001010101000101000100000001
101111111011111111101010111010101110111011111111101
100000001000000000101010100000101000000010000000101
111111101011111110101010111011101111111111101110101
100000101000100000101010001010000000001000100010001
101011101011101111101010101010111111101010111110111
101000001010001000101010101010100000100010100010101
101111111010111010101010101010111010111110101010101
101000100010000010101010101010000010001010101010001
101010111110111110101010101011111111101010101011111
100010000010001000100010101000100000000010001000001
111111111011101011101111101110101111111111101111101
100000001000101010000000001000101000000000101000001
111110101110101010111111111011111011111110101011101
100000100010101010100010000000001010000010101010001
101111111010101011101011111111101010101110111011101
101010001010101000001000001010001010100010001000101
101010101010101111111111101010111011111011101010111
101000101010101000101000001000100010000010101010001
101011101010101010101011111011101110111010101111101
101010001010100010001000100010001000001000100000001
101110111010111111101110101111101111101110111111101
100010000010100010001000101000001000001000001000001
111010111110101010111011101011111011101111111011111
100010100000101000101000101000100010001000000010001
101110101111101111101110101110101110111011111111101
101010101000100000001000100000100010001010000000101
101010101010111011111011111111111011101010111110101
101000100010100010000010000000001010001010000010001
101111111110101110111111111011101011111011101011111
100000100000101000100010001010000010001000101000001
111110101111101011101010101011111110101110101111101
100000101000001010001000101014000010101000100010001
101111101111111011101111101010111010101011111110101
101000001000000010001000101010101000100010000010101
101011111011111110101010101010101111111111101010101
100010000010000000101010100010000000000010001010101
101111111010111110111010111111111111111010111010101
100000000010100010000010000000000000001000101010101
111111111110101111111111111011111011111111101010101
100000000010100000000010001010000010000000001000101
101111111010111111101010101011111110111011111111101
100000001000000000001000101000000000001000000000001
111111111111111113111111111111111111111111111111111

R
