111111111111111111111111111111111111111111151111111
100000001010000000001000001000000000000010001000001
111111101010111011101110101110111011111110101011101
100000101000001010001000100010001010001000101000101
101111101111111010111011111011101010101011101011101
101000100000000010100010001010001000100010100010001
101010111111111110101110101011111111111010111110101
100010000010000000100010100000000000001000100010101
101111111010111111101010111111111111101011101010111
100010100010100000101010100000001000101010001010001
111010101110101111101011101111101110101110111011101
101000100000100000001000100010100010000010001000101
101110111111101111111110111010111011111010101110101
100010100000100010000010001010001000001010101010101
101010101110111110111010101010101111101011101010101
101010101000100010100010101000100000101000001000001
101010101011101010101110111110111110101111111111111
101010101000001010100010000010100010100000100010001
101110101111111010111011111010101011111110101010101
101000101010001000101010001000101000000010001000101
101011101010101111101010101111101111111011111111101
101000001010100010001010100000001000001000000010001
101111111010101010101010111111111011111111111010101
100010000010101000101000100010000000000010000010101
101010111010101111101111101011111111111010111110111
101000100010101000000000001000000000001010001000001
101111101010101111111111111111111111101011101111101
101000101010100000000000000000000010101000100000001
101011101010111111111111111111111010101011111111101
101010001010100000001000000010000010100010000000101
101010111110111011101011101010111110101110101111101
100010000010001010100010001010000010001000100000001
111011111011101010111110111111111010111011111111111
101010000010101000000010000010001010001000100000001
101010111010101011111110111010101011111110101111101
101010001000101010000010100010101010000010001000001
101011101111101010111011101110101010111011111011111
101010100000001010001000001000100010101000001000001
101010111111111110101110111011111010101110101111101
101000000000000010100010100010000010100010101000001
101111111111111011101010101111111110111010101011111
100000100010001000101010100000001004000010101000001
111010101010101110101011111111101011111110111111101
100010001000100010101000000010101000100010100000101
101111101111111110111111101010101110101010101110101
100010101000000000100000101000101000101000101010101
101010101011111111101110101110101011101011101010101
101010001000100010001010001010100010001010001010001
101011111110101010111011111010111110111110111011111
101000000000001000100000000000000010000000000000001
111113111111111111111111111111111111111111111111111

U
