111111111111111111111111111111111111111111111111111
100010000010000000100000001000000000100000100010005
111010111011111110101110101011101110111010101011101
101000100010000010100010101000100010000010001010001
101111101110111010101110101110111011111111111010111
101000100000100010001000101000001010100000001010001
101010111111101111111011101011111010101011111010101
100010000010101000100010101000100010101000000010101
101111101010101010101110101111101110101111111111101
101040001000101010101000100000001000100000100000001
101011111110101010101011111111111011111110111110101
101010000000100010001000000010000010000010000000101
101011101111111111111010111110111010101011111111101
101000101000100000000010000000101000101000001000101
101110111010101111111111111111101111101011111010101
101010000010100000100000001000100000101010000010001
101011111110111110111010101010101110101010111111111
301000000010000010001010101010001000101010100000001
101010111110111011101110101011111011101110111011111
101010100000101000100010101000100000101000100010001
101010101111101110111010101110101111101011101110101
100010101000100000101000100010100010001010000000101
111110101011101111101111111010111110101010111111101
100000101000001000000010000010000010101010101000001
111110101011111010111110111111111010101010101011101
100010101010000010100000000000000010101010101000101
101011101011111110101111111111111110101010101110101
101010001000001000101000100000100010101010001010101
101010111111101010101110101110101010101011101010101
101010001000100010101000100010001000101000100010101
101011101010111110101010111010111111111110111110101
101000101010001000100010100010100010000010000000101
101110101010111011111011101111101010101111111111101
100010001010000000100010001000001010101000000000001
111011111011111111101110111011111010101011111111111
100010000010001000101010000010001000101000100010001
101111111010111010101011111110101111101110101010101
101000001010001010001000001010100000000010101000101
101011101011101011111011101010111111111010101111111
101010001000001010000010100010000010000010100000001
101010111111101010111110111011111010111110101111101
100010001000101010001010001010000010000010100010001
101111101011101010101010101010111111101110111010111
101000001000001010101000101010000010001000101010001
101011111111111010101110101011111010111011101011101
101010000010001010100010100010000010101010000000101
111010111010101011111010111110111110101011111111101
100010101010100010001010101000100010001000100000101
101110101010111110101010101011101011111110101110101
100000001000000000100010001000001000000000001000001
111111111111111111111111111111111111111111111111111

L
