111111111111111111111111111111111111111111111111111
101000001000001000100000000000001000000010000000001
101010101011101010101110111111101011111011101110101
101010101000100010101010000000100010001000100010101
101010101010111110101011111110111110101110111110111
101010101010001000101000000010000010100010100010005
101110101110101011101111111011111011101110101010101
101000100010101000101000100010001000100010001010101
101011111010101110101010101110101110101011111011101
101010001010101010100010101000101000101000101010001
101010101011101010111110101011101011101010101010111
100010101000001010001000001010000010001010101010001
111110101111111011101111111011111110111010101010101
100000101000000010100010000010001000100010001010101
101011101011111010111010111110101111101111111010101
101010000010001000101010000000101000100000001010101
111011111111101110101011111111101010101111101011101
100010001000100000001010000000101010101010001000101
101010101010101111111010111110101010101010111110101
101010100010101000000010100010001010100010100010001
101010111110111011111110111011111010111010101011101
101010100010001000000000100000100010101010001010001
101110101011101111111111101110111010101011111010111
100010101010100000000000001000100010100000100010101
101010101010111111101111111011101110111111101010101
101010001010001000001000100010000010000000001010001
101011111011101011111011101110111011111111111011101
101000001000001004100010001000001010000010100010001
101111101011111110101110111111111010111010101110111
101010001010000010100000000000001010001000100010101
101010111010111010111111101111101010101111111010101
100010000010001010100010001000100010100010001010001
111011111111101010101011111010111110111010101011101
100010000010001000101000000010101000100010100000101
101110101110111110101111111110101011101110111111101
101000101000101000100000001000100000101000101000001
101110111011101011111111101011111111101011101011111
301000100010001010000000101000001000100000101010001
101011101110101011101110101111101010111110101010111
101010001000100010001000100000100010001000001010001
101010111111101110101111111110111111101011111011101
101010000000100000101000000010001000001010100010001
101011111110111111101011101010111011111010101110101
101000000010001000001000101010100010000010101000101
101111101011101110111110101110101111101110101110101
100000101000100010000010100010100000100000100010101
111110101110111010111110111010111110111011111010111
101000100010100010100010001010101000100010001010001
101011111110101111101011101010101011111110101011101
100000000000100000001000001000001000000000100000001
111111111111111111111111111111111111111111111111111

D
