111111111111111111111111111111111111111111111111111
100010000010000000100000100010000000000010100000001
111010111011101110101110101010101011111010101110101
100010001000001010001000101010101010001000100010101
101111101111111011111011101110101110101110111010111
100010001000100010001010001000100010100010001010001
111010111010101010101010111011111010111011111011101
101000100010001000101010001000001010101000000000101
101111101011111110111010101110111010101111111111101
100000001010000010100010100000100010101000000010001
101111101110111011101110111111101110101011111010111
100000101000101000100010101000100010101010000010001
101110111011101110111010101010111010101010111011101
101000100010000010100010001010001010101010100000101
111010101110111110101111111011101010101010101111101
100010101000100010100000100010001010100010101010001
101011101110101010111110101110111010111110101010111
101010000000101000000010100010100000001000100010001
101110111111101111101110101010111111101011111011101
101000100000100010101000101010001000100010000000101
101011101110101010101011111011101010111111111110101
100010001000101010101000000010100010001000001000101
101110111011101010101111111110111111101011101111101
301000101000101010100000001010000000001000100000101
101011101110111010101111101010111111111110111110101
101000100010400010001000100010100000000010000010001
111110101011111110111010111110111011111011111011111
100000101000000010001010000000100010001000001010001
101111111011101110111011111111101110101111101010101
100010001010001000100010000010001010100000101000101
101010101110111011101111101010111010111010101111101
101010100010000010101000001010001000001010100010001
101010111011101110101110111010101111101011111010111
101000001000100010100000101010100010001000001010001
111111111110111010111111101011101011111111101010101
100000000000100010000000001000101010000000101010101
101011111111101110111111101110111010111110101010101
101010000000100010001000000010100010100000100010101
101110111110111011101111111110101110101111101111101
100000100010001000101000000000100000101010001000001
101111111011101110101011111111101111101010111011101
101000000000101000101010000000101000101000100010101
101011101111101011101011111110101010101011101110101
100010001000001000001000000010001010001000001000101
111110111011111111111111111011111011111111111010101
100000101010000000000000100010001010100000001010005
101111101010111111111011101110101010101011111011111
101000101000100010001000001000100010001010001000001
101010101111101011101111111110111110111010101111101
100010000000001000000000000000100000001000100000001
111111111111111111111111111111111111111111111111111

L
