111111111111111111111111111111111111111111111111111
101000000000000010000010001000000010000010000010001
101011111111111010101010101011111010111010111010101
101010000010001010101000101010001010001000001000101
101010111010101010101111101010101011111011111111101
101000100010101000101000000010101000001010000010001
101111111110101111101011111110101111101110111010111
100010000010101000101010001000100010100000101010001
111010111010101010101110101011111010111111101011101
100010100010101010100010101010001010100000000000101
101110101110101010111010101010101010101111111110101
100000100000100010001000100010101010000010000010003
111111111111111111101011111110101011101110111011111
100000000000000000001000100000101000101000001010001
101111111111111111111110111011101110111011111010101
100000001010000000001000001010001010000010001000101
111111101010111110101111101010111011111110101110101
100000101010100000100000100010001010000000100010101
101110101010101111111110111111101010111111111011101
101000101000101000000010001000100010100000001000001
111010101111101011111011101010111110101111111111101
100010101000001010001000100010100000100000000010001
101111101011111110101010111110101111101111101010111
100000001000100000100010101000100010000000101010001
101111111110101111111110101011101011111110101111101
500010000010101000000000001000101000001010100000001
111010111010101011111011111110111111101010111111101
100010001010101010001000100000100010001000100000101
101111101010101110101111101111101010101111101110101
101000001000100010100000001000001000101000100010101
101011111111101010111111111011111110111010111010111
100010000000001010100010001000001000100010001010001
111110111111111010101010101111101111101110111011101
100010100010000010101010100000100010001010001000101
101010101010111010101010111110111010111011101011101
101000101010101010001000100010001000000000101010001
101111101010101011111111101111101011111111101010101
101000101010100000000000001000001010000000101010101
101110101010111111111111111011111110111110101010111
101000101010000010000000001010000000100000100010001
101010101011111010111111101010101111101111111111101
100010101010001010001000101010101000100000100000101
111110101010101011101010101011101010111110101110101
100010101000100010101010101000101010000010001010101
101110101111111010101010101110101011101011111010101
100010100010000000101010001010001000101000001400101
111010111011111111101011101011111110101111111011101
100010100010001000101000100010001000100010000010001
101110101110101010101110111110101011111010111110101
100000100000100010000010000000100000001000000000101
111111111111111111111111111111111111111111111111111

R
