111111111111111111111111111111111111111111111111111
100000001000000000000000101000000010000000000000001
111111101111111111101110101011101010111011111111101
100010001000000000001010101010101010001000001000001
101110111011111111111010101010101111101111101111101
100010001010000000101000100010100000101000101000101
111011101010111110101011101110111110101110101010101
100000101010000010101000100000100010000000100010101
101111101010111010101110111011101011111111111110101
100000100010001010100010001010001000000010000000101
111110111111101010101011101110111111111010111111101
100000100010001010001010100010001000000010001000001
101110101010111011111010111010101011111111101111111
100010101000101000100000100010101000000000100000001
101011101111101110111011101110101111111110111111101
101000101000100010001010001000100000100010000010001
101110101010101011101110111011111110101011111010101
100010100010001010100000100000000010001000001000101
101110111111111010111111111111111111111011101111101
101000100000001010000000000000100000001000100010001
101010111010101011101111111110101111101110111011101
101010001010101000001000001010001010001000101000101
111011101010111111111011101011111010111110101110101
100010001010000000001010101000000010000010000010101
101110111111111011101010101110111111111011111010111
101000000000100010001010100010100000101000001010001
101111111110101110111010111010101010101111101111101
100000001010100010000010100010101010001000100010001
111111101010111010111110101110101011101010111010111
100000101000000010100010101000001010100010001010001
101110101111111111101010101111111010111111101011101
100010100000000000001010100000000010000000001000101
111010101111111011111010111011111111101111111110101
100010100010001000001010000010001000101000100010001
101110101110101110111010111110101010101010101011101
100010101000100010100010101000100010101010001000001
111010111011111010101110101011111110111011111111111
500010000010100010100010001000000010000010000000003
101111111110101111111011101111111011111111101111101
101000000010101000001000100010001010001000001000101
101011111010101110101110111011101011101010111011101
101000100010101000100010001000001000100010001010001
101110101110101011111011101111111110111111101010111
100000101000101010001000001000000010001000001000101
101111101010101010101110111011111011101011111011101
101000101010000010101000100010001000100010001000001
101110101110111110101011101111101010111110111111101
100000100010001000101010001000001010140000000000101
111110111011111011101110111011101011101111111110101
100000001000000000100000000010001000000000000010001
111111111111111111111111111111111111111111111111111

D
