111111111111111111111111111111111111111111111111111
100010000010000010000000100000000010000000100000001
111011111010101110111110101110111110101110101111111
100010001010100000000010100010000000101000100000001
101110101010111111111110111011111111101011111011101
100010100010000010001000100000100000001010001010001
111010111111111010101010101111101111111010101110111
101010000000100010100010101000001000001000100010001
101010111110101110111011101011111010101111111011101
100010001000100010100010001000100010100000101000101
101111111011101110111110111110111010111110101110101
100000001010001000100010001010001010100000000010101
111111101010111011101011101011101110111111111110101
101000101000001000001000101000100010000000001000101
101010101111111011111010101010111010111111101011101
100010100000001000001010100010001010000010001000101
101110111111101110111010111111101011111110101110101
100010000010001000100010000010001000000010100010001
111011101110111011101011111010111111111010111111101
101010100010101000101010001010100000001010000000001
101010111010101011101010101110111110101011101111111
101000001000100010001010101000000000101000100000001
101111101111111110111110101011111111101110111111101
100000100010000010100000100010001000001000100000101
111110111010101010101111111110101111111011101111101
100000100010101010001000100000100010001010000000101
101111101110101010111110101111111010101010111110101
100000100010101010000000101000001010101010100010101
111110111011101011111111101011111010101010101010101
100000001000001000000000001000100010101010001010101
101111111111111111111111111110101110101011111110101
101000000000000000000010000000100000100010000000101
101011111111111011111011111011111111111110111011101
100010000010001000101010001000000000100000100010001
111110111010101110101010101111111110101110111010111
100000101000101000100000100010000010100010001010001
101111101111101011111111111010111010111011101111101
101000100010001000000010000010001000100010100000001
101010101110111111111010111110101110101110111111111
101010101000000010000010100000101000100010000000005
101010101011111010111110111111101111111011111011101
101010100010001000100000000000101000001000000010001
101010111110101111111111111110101011101111111110111
101010000010100000000010000000101000100000000010001
101011111010111111111010111111101110101110111111101
100010001010100000001010000000000010100010100000101
101111101010111110111011111011111010111011101110101
301000001014000000100010001010001010001010001010001
101110101011111110101110101110101111101010111011111
100000101000000000100000100000100000001000000000001
111111111111111111111111111111111111111111111111111

U
