111111111111111111111111111111111111111111131111111
100010000000100000100000000010000000001000000000101
111010111110111010111011111010111011111011111010101
101000100010000010001010001010001000100010100010001
101111101011111111101010111011101110101110101111111
100000101000001000001010100010101010101000100000001
101111101011111011111010101110101010101011111111101
100000001000000010000010101000001010001000000000101
101111111111111111101110101111101011111011101111101
101000000000000000001000100000100000100010001000001
101111111110111111111011111110111110111110111011111
100000100010000010100000000000100010000010001000001
111110101011101010101111111111101011111011101111101
100010101000101010101000001000001010001000000000101
101110101110111010101011101010101110101111101111101
101000101010000010101010101010101000100000101000001
101011101011111110101010101010111011101011101011101
101000101010001000101010101010000010101010001010001
101110101010101010101010101011111110101010111011101
100010001000100010001010101010000000101010001000101
101011111011111111111010101010101110101110111110101
101000001010000000000010101010100010100000100000101
101110111010111111111010101011111011111110101111101
101010100010000010001000100000001010000010100000101
101010101111111110101111111111101010111011101110111
101010101000001000100000001000101010101000100010001
101010101011101011111111101010101010101110101111141
101000100010100010000000001010101010100010101000001
101011111110111110111111111010101010101010111011101
101000100000001010000000100010100010101010000010001
101110101111101011111110101110111010111011111110111
101010001000101000000010100010001010001000100010101
101011111010101011111110111111101011101110101010101
101010000010001000100010000010001010100010101010001
101010111111101110101011111010111010111010101011101
101000001000100000101000001010000000100010001000101
101111111010111110101110101011111111101111111010101
100000000010001000101010101010001000100000001010001
101111111111101110101010111010101010101111101011111
101000000010100010100010000010100010100000101010001
101010111010111011111011111110111110111110101011101
101010101010001000100010000010000010000010101000001
101110101010101110101111101010111011111011101111101
100000101010100010100000101000101010000000100000101
111111101010111110111110111110101011111110111110101
100010000010000010000010000010001000001010100010101
101010111111111011101011111011101111101010101010101
101010001000100000101000001000101000101010001000101
101111101010101110101111111110111010101011111111101
100000000010001000100000000000000010001000000000001
111111111111111511111111111111111111111111111111111

D
