111511111111111111111111111111111111111111111111111
101000001000100000000000001000000000100000000000001
101011101011101011111111101111101111101111101011111
101010001000001000100000000010001000100010101010001
101010111011111110111111111010111010111010101010101
100010100010100010000000101010100010001010101010101
111110101110101011111110101010101111101010101110101
100010100010001000100010101010000000100010100000101
101110111011111011101010101011111110111110111111101
100000100000000010001010101000101000100010000010001
101111111110111110111010101110101011101010111110101
101000000010100010101010101000101010001010100000101
101110111011101010101010101011101011101010101111101
100000101000001000101000100010000000101000100010001
111111101111111111101111101111111110101011111011111
100000000000100010000000100000000010001010001000001
101110111110101010111110111111111011111110101110101
101000100000101010100010000000100010000000100010101
111011101111111010111011111110101110111111111011101
100010100000100010000000100010101000100000001010001
101110111110101011111110101010101110101011111010111
100010001000101010000010001010100000101000100010001
101011101011101110111011111010111111111010101110101
101000100000001000100000001010100000001010101000101
111110111111111011101111101010101110101110101011101
100000100010001010100010001010000010100000101010001
101110101010101010111011111011111010111011101110101
101000101000100010001010000010001010001010001000101
101011101111111110101010111110101110101010111011101
101010001000100000101000100010100010101010100010001
101110111010101111101111111010111011101110101010111
100010000010101000100000000010001000100010101010101
101011111110111010111110111011101110111010111010101
101000000010000010000010001000100010000010100010101
101111111011111111111410101111111011111010101110101
101010000000100000001010100000001000001010101000101
101010111110111010101011111010101111101110101110101
100010000010001010101000001010101000001000100010001
111011111011101110101111101010101011111011111011101
101010100010100000101000101010101000000010000010101
101010101110111111101110101110101111111110111110101
101010100010000000001000100010100010000000100000101
101010111011111011111010111010111010111110101110101
101000001010001000000010001000100010100000101010001
101111101010101111111111101111101111101111101011111
100000101000100000100000000010001000001010001000001
101110101111111110111011111110111011111010111111101
101000101000000010001010001000100010000010000000001
101111101110111011101110101011111010101111111111101
100000000000100000100000100000000010100000000000001
111111111111111111111111111111111111111311111111111

U
