111111111111111111111111111511111111111111111111111
100010001000000000100000000010001000001000000010001
111010101011111110101111111010111010101011101110101
101010100010000010001000100010000010100010001000101
101010111110111011111010101110111110111110111011101
101010000010001000001010101010001010000010100000101
101011111010111110111010101011101011111011101111101
100010000010100000100010001000100010001000101000001
101110111111101110101111111011111011101110101011101
100000100010001000100000100010001000000010101010001
111111101010111011111110111010101110111110101011111
100010001000100010000010001000100000100010001000001
101010111111101111101011101011111111101010111111101
101000100000100000001010101010000010001010100010001
101111101111111111111010101110111010111011101010101
101000000000001000100010100010101000101000001000101
101011111111101010101110111010101111101111111111101
101000000000100010100000001000100000100000100000101
101111111110111110111111101111101011101011101110101
100000100010100010000000101000101010001010001010001
111110101010111010101111101010101010111010111011111
100000101010000010101000101010001000100010101000001
101111101011111010111010101011111111101010101011101
100010001010100010001010101010000010001010101010001
111011101010101111101010101110111010111010101010111
100010001000100010100010100000101000101010100010001
101110111111111010111110111111101111101010101111101
101000000000001000100010000000001000001010100010001
101011111111101110111011111110111011101010111010111
101000001000100010001000100010100010001010100010001
101111101110101111101010111010101110111010111011101
101000001000100000101010000010001000100010001010001
101011111011111110101011111111111010101111101010101
101010000010000000101010000000001010101010001010101
101010111110111111101010111011101011101010111110101
101010000010001000101000001010001010001010401000101
101010111011101010101011111011111010111011101011101
101010100000101010101010000010001000000000100010101
101010101111101010101010111010101111111110111110101
101010101000001010001010100010100010100000000000101
101011101011111011111010111110111010101111111011101
101000001010001000001010001000101010001000001010001
101111101010101111101111101011101011111011101110111
101000001000100000000000001010001000000000101000101
101011111111111111111110111010111111111111101011101
101010001000100000000010100010000000100000101000001
101110101010101111111011101111111110101110101111101
100000101010100010001000001000000000100010000000101
101111101010111011101111111011111110111011111111101
100000100010000000000000000010000000001000000000001
111111111111111111111111111111111111111111111113111

L
