111111111111111111111111111111111111111111111111111
101000000010000010000000001000100000100010000000001
101011111010101010111111101110101110101010111110101
101000100010101010001000100010001000101000101000101
101110101111101011101010111011111011101111101011101
100000100010001000001010001000001010001000001010101
111111111010111111111011101111101010111011101010101
100000001010100000001000100000101000100010001010101
101111111010101111101111111010101110111110101010101
101000100010000000100000001010100010000000101010101
101010101111111110111111101011111011111110111010101
100010100000001000000010001010001000100010100010001
101110111111101011111114111010101110101010101111101
100010000010001000100000100010100010101000100000101
111011101110111111101111101010101110101111111110101
101000100000100000100010101000100000100010001000101
101110111111101010111010101111111111111011101011111
300010001000001010001010101000001000001000101000005
101111101011111011101010101010101111101110101111101
100000101000100010000010101010100000101000001000101
101110101111101111111110101110111110101011111010101
101000100000100000100000101000100010101000100010001
101011111110101110111010101011101110101110101111111
101000000010101010001010100010001000101000100010001
101111101110101011101010111111101011101011111010101
100000100000100010001010000000001000101000001000101
111110111111111110111010111111101110101111101111101
100010001000000010001010001000000010100000001000001
101011101110111011101110101111111110111111111011101
101000001000101000100010101000000000100000000010101
101111111011101110111010101011111111101111111110101
100010000010000010000010101010001000001000000010001
111011101111111011111110101010101011101111101010111
101000001000001000101000101000101000100010001010001
101111111011101010101011101111101111111010101111101
101000000010100010101000100000100000000010101000001
101011101110111110101110111110111111111110111011111
101010100010100000100010100010000010000010001000101
101010111010101111111010101010111010111110101110101
101000001010000010000010101010001000100000100010101
101111101011111010111110101111101111101111101010101
100000101000001000100000100000100010001000001010001
101110101111101111101111111010111010111011111011101
100010100000100000100000001010100010101000101010101
111110111110111110111111101110101010101110101010101
100000000010000010000000100010101010000010100000101
101111111011111011101011111010101110111110101111101
100010001000001010101010001010100010100000101000101
101010101111111010101110101010111010101111111010101
101000100000000000100000100000001000100000000010001
111111111111111111111111111111111111111111111111111

U
