111111111111111111111111111113111111111111111111111
101000100000001000000010000010000000100000001000001
101010101110101011111010101110101111101110111010101
100010100010101010001010101000100000100010000010101
111110111010111010101010101011111110111011111110111
101000100010000010101000101000100010001000100010001
101011101111111111101111101110101111101110101111101
100010001000000000000010100010101000000010100000101
101110111111101111111010111010101011111010111110101
101000000000001000000000001000101000001010000000101
101111111111111011111111101111101111101110111111101
100000100010000000100000100000000000101000100000101
111110101010111111101110111111101111101011101110101
100010101010001000001000100000101000041010101010001
111010101110111011111011101111101011101010101011101
100010100000100010001000101000101010001010101000001
101010111111101110111110101010101011111010101111101
101010000000001010000010100010101000000000100000101
101111111111111010111010101110101111111110111110111
100000000000001000101000100010000010000010100010001
101111101111111011101111111111111110111010101111101
100010100000000010000000100000001000101010101000001
111010111111111110101110101111101011101010101011101
100010100000000010101000001000001000100010001010101
101110101011111011101111111011111010111011101010101
100010001000001000100000100010000010001010001010001
111010111111101110111110101111111111101011111011111
100010001000001000001000101000000000101000100010001
101110111011111111101011101011111110101110101010101
101000100010000010101000101010000000001010101010101
101011101110111010101010101011111111111010101110101
101010001000101010101010101000000010000010100010101
101010111011101010101010101011111010111110101010101
101010000000001010001010101000001010000000101000101
101110111110111010111110101011111010111111111110101
100010100010100010000000101010001010100000000010101
111011101011101111111111101110101010101111111010101
100010001000100010001000001000100010100000101010101
101110111110101011101011111011111110111110101011101
100010100000101000100000000010000010001000101000101
111010111011101110111111111110111011101011101110101
101010001010000010001010000010101000001010000000101
101010101011101111101010111010101111111011101111101
101010101000101000001000100010000000001000101000101
101011101110111011111111101011111111101110101010101
101000101000001000100000001000000000100000101010001
101110101111101110111011111111111111111111101011101
100000100010100010001010001000100000000000100010001
101111111010111011101010101010101111111011111110111
100000000010000000001000100010000000001000000000001
111111111111111111111511111111111111111111111111111

L
