111111111111111111111111111111111111111113111111111
101000100000001000000010000010000000000000100000001
101010111011101111101010111010111111111010101111101
101010100010100000001010100010000010001010101000101
101010101110111111111011101111111010101010101110101
100010001010000010001010001000100010100010001000101
111111111010101110101010111010101110111111111011101
100010001000100000100010001010000010001000000010001
101110101011111111111110101011111110101111101110111
101000101000100000001000100000100010100000101000101
101011101110111111101011111111101011111110101011101
100010100010100000100010001010001000000000101010001
101110101010101110101110101010111111111111101011101
100000101010101010100010101010000000001000001010001
111110101010101010111010101011111111101011101010111
100000101010101010100000101000100000001000100010001
111111101010101010111111101011101111101111111011101
100000101010001010100000101010001000001000001000001
101110101011111010101110101010111111111011101111101
101000001010001010001000100010000000000000101010001
101111111010101011111011111111101111111011101010111
100010001010100000001000000000101000001010001000001
101010111010111111111111111110111011101010111111101
101010000000100000000000001010001010101010100000101
111011111011101111111110101011101010101110101110101
100010001010001000001000100010100010001000101000101
101110101110111111101011111010111110111011101011101
100000100000000000001010001010001010101000001010001
111111111111111111101010101010101010101011111010111
100000000000000010001000101000101010100000100010001
101111111111111010111111101111101010111111101111101
101000000010100010000010100000100010000000001010001
101011111010101111111010111110111111111111111010111
100000001010101000001000000010000000000010000010001
101111111010101011101110111110111111101011101111101
101000000010000010001010100010001000001010001000101
101011111111111110111010101011111011111010111010101
101010000000001010100000101000000010000000100010001
111010111111101010111111101111111110111111101111111
100010000010001010000000001000100000100000001000001
101011111010111011111110111010111111101111111011111
101010000010100010000010100010000000001000000000001
101110111110111010111010101111111111111111101111101
101000000010001000001000100010001000000000100000101
101011111111101111111111111011101010111110101111101
101010100000001000001000001000100010100010101000001
101010141111111011101010101110111110101110111011101
100010100000001000101010101000100010100000100010001
101110111111101110101010111011101010101111101110111
100000000000100000100010000000001000100000001000001
111511111111111111111111111111111111111111111111111

U
