111111111111111111111111111111111111111111111111111
100010001000000010000000000010000000000010000000001
111010101010111011111110111011111111101011111111101
101000101010101000000000101010000010001010000000001
101111101010101011111111101010111010111010111111101
101000001010100010001010000010101000101000100000001
101011111110111110101010111110101111101111101111111
101000100000100000101000100000101000000000101000001
101110101110101111101110111011101011111010101110101
100000100010101000100010100010001010001010100000101
101111111010101010111010101110101010101011111111101
101000001010101010001010101010100010101000000010001
101011101011101111101010101010111110101111101110111
100010101000000010001010001010000000101000100010001
111110101011111010111011111011111111101010111011101
100010001010001000100010000000000000101010001000101
101110111110101110101111101111101111101111101011101
100010000000101000101000100010001000001000001010001
111011111111101011101010111110111011111011101010111
100000100000001000100010001000100000000010001000101
101011101111111110111111101011101111111111111110101
101010001000001010100010001000001000000000000010001
101010111010101010101010111111111011111111111011101
101010001010100010101010000000100010000010000010001
101111101010111110101011111110101111101010111110111
101000001010100010101000100010101000001010100010001
101011111010101010101010111010101011111110101011101
101010000010101000101010000010000010000000101010001
101011111110101111111011111111111110111111101010111
101010000010100000000010000000000000100010001000101
101010111010111111111010111011111111101010111111101
101010100000001000001010100010000000101010000010001
101010111111111010111010111110111110101011111011101
101010000000001010000010000000101000101000001000101
101010111111101011111111111111101011101111101110101
300010000010101000100000001000001000000000101010001
101111111010101110111110101110111111111111101011101
101000101000100010100000100000100000000000001010001
101010101110101110101111111011101111111111111010111
101010101000101000101000000010001000000010000000101
101010101011101011101111111010111011101110111111101
101010100000100000100010001010100010100000100000001
101010101111111110111010101110101110111111101111111
101410101000001010000010100000100010001000000000005
101010111011101011111010111111111010101111111111101
100010001010101000001010001010001000100000000000001
111111101010101111101011101010101111111111111111101
101000100010100000100000101000100000001000000000101
101010111110111110111111101011111110111010111111101
100010000000000000000000001000000010000010000000001
111111111111111111111111111111111111111111111111111

U
