111111111111111111111111111111111111111111111111111
100000100000000010000000001000000010000000100000001
111110111110111010111011101011101110101111101111101
100010000000101010100010001000100000101000101000005
101011111111101011101111111110111111101010101011111
101000100000000010001000100000000000100010001010001
101110101111111110111010101111111111111111111010101
101000100010001010000010001000000000000000001000101
101011111010101010111111101011111111111111101011101
101000001000101000100000101010000010000010001010001
101110111111101011101110101010101110111010111110101
100010000010001010001000101010100000101000100010101
111011101110111110111110111010111111101111101010101
101010100010000010000010100010100000000010001000101
101010111011111011101010101110111110111010111111101
101010001000001000101010101010000000101010101000001
101010101010111110111010101011111111101010101011111
101000101010100010001010001000000000001010100010001
101011111011101011101011111010111111111010101110101
100010000010001000001000001010100000100010100000101
101110111010111111111111101110101110101110111111101
101010001010100010000010001000100010001000100010101
101011101010101011101010111010111011111010101010101
100000101010101000001000100010001010000010001010101
111011101110101111111111101111111011111111111010101
100010001000101000100000100000001000000000001010001
101110111011101010111010101111101111111111101011101
101010000010100010001010001000100000000010001000101
101011111110101111101011111010111011111110111110101
100010001000001000101010000010001000100000100000101
111011101011111110101010101111111110101111101111111
101000100000000000101010100000000010001000001000001
101110101111111111101011111011101011111110111011101
100000101010000000001000001010001000100010100010001
101111101010111111111111101110111110101010101110101
100000101010100000001000100000100010001010101000101
111110101010101111101011111111101011111010101011111
300010100010001010001000000010001000001010101000001
111010111011111010111011101010111011111010101111101
100010101000001010100010001010101000000010101010001
101110101111101010101110111010101111111110101010111
100000100000100010100010001010000000100000101010001
101111111110111010111011101111111110101111101011101
100000000010000010100000100000000010100000000010001
111111111011111110111111111011111010111011111110101
100000001000100010000000100010001010001010001000101
101111101110101010111110101010101111101010101011101
100000101000101010104000101010100000001010101010001
101110111011101011101111101110111111111110101010111
100010000000001000001000000000000000000000100010001
111111111111111111111111111111111111111111111111111

R
