111111111111111111111111111111111111111111111111111
101000001000001000000010000000100000000000000000001
101010101110101111101010111110111111101111111111111
101010100000101000001000100010000000100010000000001
101010111111101011111111101011111110101010111111101
101010100000100010000010001000000010101000100000101
101110101111111110101010111110111110101111111110101
100000101000001000101000100010100000101000000010101
111111101011101011101111101010101111101111101010101
100000001010100010101000001010100010100010001000101
101111101010111110101011111010111010111010111110101
100010001010000000100010100010001010100000100000101
111011111010111110111110101111111010101111111111101
100010000010100010001000100000000010101000000000105
101110111110101011101110111111111110101011111110101
100010100000101000100010000000100000001010000000101
111010101111101111111011111010111111111010111111101
100010100010001000001000000010000000000010101000001
101010101010101010111111111111111111111110101010111
101010101010100010100010000010000010000000100010001
101110111011101110101010101110111010111111101111101
100010001000100010001010100000101000101000001000001
101011101110111111111010111111101111101011111011101
101000100010001000001000100000000000100010000010101
101110111010101011101011111110111110101110111110101
300010000010100010001010000000100010101010100000101
111011111110111110111011101111101010101010111110101
101000100010000010101000001000001010101010100010001
101110101011111010101111111011101110101010101010111
100010101000001010100000000000100010100010001010101
101010111110101010111111111110111010111011111010101
101010000010100010000010000010100010001010001010001
111011111011111111111010111011101011101110101011101
100000001010000000000010001000101000100000101010001
101111111010111111111111101110101111111111101010111
101000040010100000001000000010101000000000100010101
101011111110101111101011111110101011101110111110101
101000100000001000100000100000100010101000100000101
101110101111101010111111101111101110101110101111101
101000101000101010000010001000100010100010100000001
101011101010101011111010111011111010111010111111101
101010001010101000100010001010001000001010000010101
101011101010111110101111101010101110111011111010101
101000101010100000100010001000100010100010100000101
101110101010101111111010111011111010101110101111101
101000101010001000001000101000001010100010001000101
101011101011111110101111101111101010111010111010101
101010001010000000100000000010001000101010001010001
101011111010111011111111111110111111101011111011111
100000000010001000000000000000000000001000000000001
111111111111111111111111111111111111111111111111111

L
