111111111111111111111111111111111111111111111111111
101000000010000000001010000000100000000000000010001
101110111010111111101010111010111011111011111010101
100000101000100010101000100010001010000010001000101
111111101111101010101011101111101110111110111111101
100010000000001000101010100010101000100010000010001
101110101111111011101010111010101011101011111010111
100000101000100010001000101010001010001000000010001
101111101010111110111110101011101010111111111011101
100000100010100000101000001000100010100000001010101
111110111110101111101011111110111110101111101010101
100000100010101000100010000010100010101000101000101
101111111010101010111110111010101010101110101011101
100000001010100010000000100010101010001000101010001
111111101010111111111111101110101010111010101110111
100000100010100000001010001000001010000010100000101
101110111110101110101010111110111011111110111111101
101010000000101010100010000010001000100010000000101
101010111111101010111011111011101110101011111110101
101000100000100010100000001000100010101000100000101
101111101110111010111111101110111110101011101111101
101000001010000010000010001000100000101010001000001
101011111011111111111010111011101111101110111011101
301010000000000010001010100010001000001000101000101
101011111011101110101010101110111010111011101110101
101004100010001000101010100000100010001000100000101
101110101111111011101011111111101111101110101111101
100010001000000010000010000000100010100010100000101
101011101011111111111010111010111010111010111011101
101000001000100000100010001010100010001000101010001
101111111110101110111111101010101110111111101010111
101000100010100010000000001010100010000000000010001
101011101010111011111111111011111010111110111111101
100010001010001010000010001010000010100010001000101
111010111010101011101010101010111111101011101010101
101010100010101000001010100010100000001010001010101
101010101110101111101110111110101011111010111011101
100010100000100010001000100000101010001010001010001
101110111011111010111010101111111010111011101010101
101010001010001010101010101000100010000010000010101
101011101110101110101011101010101110111110111110101
101000100000101000101000100010001010001000101000105
101010111111101011101110111111111011101110101011101
101010001000100010000010000010000000100010101010001
101011101011111110111011111010111110111010101011111
101000101000000000100010001000100000100010001000001
101110101111101111101110101111101111101111111111101
100010101000101010001000101000100010001000000010001
111010101010101010111011101010111010111011111010101
100000100010001000000010000010001000000010000000101
111111111111111111111111111111111111111111111111111

L
