111111111111111111111111111111111111111111111111111
100000100000001000000010000000100000001010000000003
111110111011101010111011111010111010101010101111101
100010001000101010001000000010001010100010100010101
101011101011101011101111111111101110111110111010101
101000101010001010001004000010100010000000101010101
111010101010101010111011111010111011111011101010101
100010101010101010001000100010000010001010001010001
101111101110101011101110101111101110101010101010111
100000100010101010001000100000100000101000101010001
101110111010111010111011111110111111101111111011101
100010100010001010100010000010000010101000001010101
111110101110101010101110111111111010101011101010101
100000101000101010001000000000100010000010001010001
101110101111101011111110111011101111111110111011111
101000100010001010000010001010001000001000100000001
101111111010111011101011111010111011101011111111101
100000001010000000001000100010000000101000000000101
111110101011111111111110101111111111101111111110101
100000101000000010000010100010000000100010000010101
101111111111111010111010111010111110101010111010101
501000001000001010100010000010101000101010001010101
101011101011101010101111111110101011111010101110101
100010100000101000101000100010100010000010100000101
101110111111101111101010101010101110101110111111101
100000101000000000100010001000101000101010100000001
111110101011111110111111111111101111101010111011101
100010101010001000001000000000101000001010001000101
101010101010101011111010111111101011111011101010111
101010101010100010001010000010001010001000101010001
101010101011111110101011111010111010101010101111101
101010001010000000101010001000100010100010000000001
101111101010111111101010101111101110111111111111101
101000001010100000101010100000000010000000001000101
101011111010101110101010111111111011111110111010111
101000001000101000100010001000001000000010100010001
101111101111101111111111111011101111111010101111101
100000101010000000000000000010100000001010100010101
101110101010111111111110111110111111101011111010101
101000101000100000000010001000000000101000001000101
101011101011101111111110101010111111101110111110101
101010101000001000000010101010001000100010000000101
101010101111101011111010101011101010111010111111101
101000100000101010000010101010100010001010100010001
101111111110111010111111101010111110111010101010111
100010000010100010000010001000001010100010101010001
101010101110101111111010111111101010101110101011101
101000101000101010001010001000001010001000001010001
101111101011101010101011101011111011111111111110101
100000100000001000100000001000000000000000000000101
111111111111111111111111111111111111111111111111111

R
