111111111111111111111111111111111111111111111111111
101000101000001000000000100000000000000000100000001
101010101010101011111011101111111111101110111011111
100010101010100010001010001000101000100010001000001
111110101010111111101010111010101010101011101110101
101000100010000000100010000010001010101010100010101
101011101111111110101111111011111010111010111011101
101010001000001000100010000010000010000010001000003
101011111011101011111110111110111111111111101111101
101000000010101000000000000010100000001000001000001
101111111110101111111011111110101111111010101011111
100000001000100000001010000010100000100010101010001
101110101011111111101010111010101110101110111011101
101000101010000010001010101000100010101010100010001
101011101010111010111010101111111110101010101110101
101000100010101010100010100000100010101010100000101
101110111010101010101110101110101010101010111111101
100010100010001000101000101000101010101010000000101
111010101111101111111011101011101010101010111111101
101010100010101000100010001010001000101010000010001
101010111010101010101110101010111011101011111010111
100010101010100010100010101000101010001000100010101
101110101010111110111010101111101010111110101110101
100010100000000010100010100010001010000010101000101
111010101111111010101111111010111011111010101011101
100010101000100010101000000010100000001000101000001
101110111010111010101110111110101111111011101111101
101000100010001010100010100010000010000010001000101
101011101111101110111010101010111110111110101011101
101010001000100010000010001010001000001000101010001
101010111010111011111110111011111011111411101010111
101010100010000000100010001010000010000010000010101
101010101110111110111011101010111110111110111110101
101010101000100010001000101000100010100000001000101
111010101111101011101110101111111010101111111011101
500010100000001010000000101000001010100010000010001
101110111111111010111111101010101010111110111110101
100010001000000010001000001010101010100000100010101
111011101011111111101011111110101010101111101011101
100010001000001000001000000000101010100000001000101
101010111111101011111111111111101010111111111110101
101010000010101000000000000000101010000000000010101
101111111010101111101111111110101011111111101110101
100000001000100000101000000010101000100010001000101
101111101110111110101011111010101010101010101011101
101000001000100010101000100010100010001010101000001
101011111011111010111110101111111111111010101111101
101010001000001010000000100000100000100010101000001
101010101111101011111111111110101110101110111011111
101000100000000000000000000010000010000010000000001
111111111111111111111111111111111111111111111111111

U
