111111111111111111111111111111111111111111111111111
101000000010000000001000000010000000000000100000001
101110111010111111111011101110111110111011101110111
100010100010100000000000100010100000100010000010001
111010101110101111111111111010101111101110111111101
101000101000000000001000001000100010100010101000001
101111101111111110111011101011111010111010101011101
100000100000001000100010001000100010001010001010001
101010111111101111101110111111101110101011101011101
101010000010100000001000100000001000100010001000101
101011111010111111111011111011111110111110111110111
101000101000100000001000001000000010101000100010001
101110101110111011111111101111111010101011101011101
101000101000000010000000001000000010101000101000101
101011101011111110111111111011111110101110111110101
101010000010001000100000001000001010000010100000101
111011111110101011101011111011101010111110101110101
100010000000100010101000000010001000100010101000101
101110111111111110101111111110111111101010101011101
100010100000100000001010000010000000001000001010001
111010111010101111111010111011111111111111111110101
100010100010101000001000001000000000000000100000101
101010101110101110101011111110111111111011101111101
301010001000100000101000100010001000001010001010005
101111111011111111101011101011101011101010111010111
100000001000100000001010001000001000101010100000001
101110111110111011111010111111101110101110111111111
101000100010001000001010100010001000100010000000001
101011101011101111101110101110111011111010111111101
101010001000001000101000101000100010001010000010001
111010111111111011101011101011101110101011111010111
100010001000000000100010000010001010101000001010001
101111101111111010101111101110111010101111101111101
100000101000001010001000101010001000100000100000001
101110101011101110111010101011101011111011111111101
100010001000100010001010100000101000001000000000001
111011111010111011111010101111101111111011111111101
100010001010001000000010101000001000001010001000101
101110101111101111111110111011101011101110101010111
101000101400101000100000100010001010100000100010001
101011101010101110101111101110111010111111111111101
100010100010100010000000001000001000100010000000001
111110111110101011111111111110111110101010111111101
100000001010101010000000000010100000001010100010001
101110101010111010111111111010101111111110111010111
101000100010001010001000100010101010000010001010001
111010111111101011101110101111101010111011101011101
100010100000001000000000100000000010001010001000101
101111101111111111111111111111111111101010111011101
100000000000000000000000000000000000001000100000001
111111111111111111111111111111111111111111111111111

R
