111111111111131111111111111111111111111111111111111
100010000000000000101000000000000000000000000000101
111011101111111110101011111111111011111111101110101
101000001000000000100000100010001010001000001010001
101111111011111111111110111010101110101011111011101
100000101010400000000010001010100000100010100000101
101110101010111111111011101010111111111110101011101
101000101010100000001010000010100000100010101000101
101011101010111110111010111110101110101010101110101
101000001010000010100010100010101010001010101010001
101111111011101010101111101010101011111010101011111
100000001000101010101000001000101000000010101000001
101111101110111010101011111111101110111110101011101
101000100010100010100010100000100010001000101000101
101110111010101110111110101110101011101110101111101
100010001000101000001000001010001000100000100000101
111011101111101011111011111011111110111110111110101
101000000000001000000010000000000010001000100010001
101111111111111110111110101111111011101110101111101
101000001000000010000010101010001000100010001000001
101011101011101011111011101010101110111011101011111
101010101010101000100000001010100010100010001010001
101010101010101110111111111010111010101111111010101
101010100010101000000010000000001000100010000010101
101010111110101111111010111111111110111010111111101
101000001000100000100010101000000010001010001000001
101111101110111110101110101011111011111011101110101
100000100000001000101000101010001010000000100000101
111010111011111011101011101010101010111110111111101
100010001010001010001010001010101010100000000010001
101111101010101010111010111010101010111111111110111
100000101010100010100010100010100000100000100000101
101110101010111110101110101110111111101110101111101
101000101010100010100000100010001000000010100010001
101010111010111010111111111010111011111110111011101
101010100010001000100000100010100010100000001010001
101010101111101011101110101111101110101111111010111
101010100010001000001000001000000000101000000010001
111011111010111111101111111011111111101011111111101
100010001010000010101000001010001000001000100000001
101110101011111010101011101010101011111110101011101
100010100010001010001010100010101000100010101000101
101010111110111011111010111110101110101010111110111
101000100000100010001010000000101000101000100010001
101111111011101010101010111111101010101111101011101
101000001000101010101000101000001010100000101000101
101011101010101110101111101011111011111110101110101
101000101010100010100000100010000010000010100010101
101110101110111010111110101110111110111010111010101
100000100000001000000010000010000000001000000010001
111111111111111111111115111111111111111111111111111

R
