111111111111111111111111151111111111111111111111111
100000101000001000001000000010001000001000001000001
111110101011101010101111111010101010111010101011101
101000100010100010100000100010100010001010101010001
101011101110111110111110101010111111101010111010101
101000100010001010100010001010100000101010100010101
101110111010101010101011111010111110101010101110101
100010001000100010001010000010001000100010001000101
101111101111111011111011111111101011111111111011111
101000001000001000001010000000001000000000001000001
101011111011101111111010111111111011111111101111101
101000000010100000001010001000001010000010001010001
101111111110111111101011101110101011111010101010111
100000000000101000101000100010101000100010101010001
101110111110101010101110111011101110101110101011101
101000100010100010100010001000100000001000100000101
101011101110111110111010101110111111111011111110101
101010000000000000101010100010000000001000100010101
111010111111111110101010111011111111101110101010101
100010100000100010001010100000001000000000101000101
101111101110101111101010101111111011111111111011101
100000001010100000001010100010000010001000001010001
101111111010101111111010111110111111101011101110111
100000000010100010000010100000000000001010000010001
111111111110111110111110101111111111111011111011101
100000100000100000100000000010000000001000101000001
101110101011101111111111111110111111101010101111101
101010001010001000000000000010100000101010100010001
101011111010111111101111111010101110101110101010111
101000000010000000001000001010000010100000101000101
101111111011111111111010101011111110111111101111101
100010001010000000100010101000000000100000001000001
101010101110111110101110111111111111101111111011101
101010100000100010100010000000000000101000100010101
101010111111111010111011111111111110101010111010101
101000100000000010001010001000100000100010001000101
101111111111101111101010101010101011111111101111101
100010000000100010001010101010101010000000001000001
111011101110111010101010101110101010111111111011101
101000401010100010101000100010101010100010000010001
101111111010101010111111111010101110101010111111101
100000000010001010000010001000100010001010100000101
101111111011111011111010101110111011111010101110111
101010001000101010001000100000101000001010000010001
101010101110101010101111111111101011111011111011101
101000100000001010100000100000001000000010001000101
101111101111111011111010101111101111111110101111101
101000100010001000100010100000101000001000100010001
101010111110101110101110111110101011101110111010101
100010000000100000001000000000100010000000100000101
111111111111111111111111111111111111111311111111111

L
