111111111111111111111111111111111311111111111111111
101000100000001000001000100000100000000010000000001
101010111011101011101010101010101111101110111110101
100010001000100010001010001010101000100000001010101
111111101010111110111011111011101010111111101010101
100010101010001010001000001000001010100010000010101
101010101111101011101111101111111010101011111110101
101000101000001000101000101000001010101010000000101
101111101011111010101010111011101010101010111111101
101000101000001010001010100010100010001000100010001
101010101011101011111010101110111111111111111010111
100010001000101000001010001000000010000010001010001
101111111111101111101011111011111011101010101011101
101000000000001000100010001000001000001000101000101
101011111111111011111110101011101111111111101011101
101010000000100000000000101010100010000010001010001
101010111011101111111111101010111010111010111010111
100010101010001000100000100000100010100010100010001
111110101010111010101111111111101110111110111011101
100010101010001010001000000000001010000000000010001
101110101011101011101011111111111010111111101110111
100000001000101010101000000010001000100000101000101
101111111110101010101111111010101011101110111011101
100000100000100010001000001010100010101010001000101
111110101110111110111110111010111110101011101110101
101000101000000010100000100010000000100010101400101
101011101111111110101111101111111110111010101011101
101000100000100000001000001010000010001000100010001
101110111110101111111011111010111011101110111110101
100010001010101000100010001000101000001010100010101
111011101010101110101111101011101111111010101110101
100000101010100010101000001010000000000010101000101
101111101010111010101011111011111110111110101011101
100000100010000010101000000000100010000010100010001
111110111011111110101111111110101010111010111110101
100000001000100000100000001010101010100010000000101
101011111110101011111111101010101011101011111111101
101010000000101010000000101000001010001010000010001
101010111111101010101110101111111010111010111010111
101010001000101000101000100000101000100010101000101
101111101010111111101110111110101011111110101111101
101000100010000000100010100010100010001000100000001
101010111111111110101010101010101110101011101011101
100010100000100000101010001010101000100010001010101
101110101011101111111011111010101011111111111010101
101010001000101000000010001010101010000010000010001
101011111110101111101110101010101010111010111110111
101000001010001000101000100010101010001000100000101
101110101011111010101011111110111011101111101111101
100000100000000010001000000010000000001000000000001
111111111111111111151111111111111111111111111111111

D
