111111111111111111111111131111111111111111111111111
100010000000000010000000100000100000000010001000001
111011101011111011101110101110111110101010101011101
101000101000001000001000100010000010101000101010001
101110101111101111111011111011111010101111101010101
100010101000101000001000000010001010100000101010101
101110101010101110101111111110111010111110101110101
101000101010100010101000000010001010100000100000101
101011101010111010111011111010101010101111111111101
100010001010001010000000001000101010101000001000001
101110111011101011111110111110101011101010101011111
100010101000101000001000100010101000001010101000101
111010101110101111101111101011101111111110101110101
101010101000100000100000001000100000000000100010001
101010101011101111111111111110101011111111111011101
101010100010100000000000100010101000001000100010001
101010101110111111101111101010111111101010101110111
101010100000000000100000101000100000101010100010101
101010111111101111111110101111101110101010111010101
101010000000101000000000100000100010100010100010001
101011111110111011111111101110111010111410111111101
100010100010000010001000101000001010001010100000001
101110101011101110101010101011111011101010101111111
101000001000001000101010101000000010001010001000101
101111111111111011101010111111111110111011111010101
101000000000000010001010000000100010001010000010101
101011111111111110111011111110101010101011111010101
100010100010001000100010000010001010101000100010001
111110101010101011101010111011111010101110101111111
100010001000100010001000001000001010101010100010001
101010111111111111111111111111101011101010101010101
101010000000001000000000000000101000001010101000101
111011111111101011111111111110101111111010111111101
100000100000001000100000000010101010000000100000001
101110101111111110101111101010101010111111101111101
101000100000000010101000101010001010100000100010101
101110111111111010101010101111111010101111101010101
100010000000001000101010100000001000101000001010001
111011111111101111101011111011111011101011111010111
100010001000101000101000001000001010001010000010101
101110111010101110101011101111101010101010111110101
100010000010000000101000100000100010100010100000001
101011111011111111101111111010111110111110111111101
101000001010100000100000100010001010101000100010001
101111101010101110111110101111101010101011101011111
101000101000101010000000101000101000101000001000001
101010101110101011111111101011101011101111101111101
100010100010100000100000001000101000001000101000001
111110111011111110111110111010101111111010111011101
100000001000000000000000100010000000000010000010001
111111111111111511111111111111111111111111111111111

D
