111111111111111111111111111111111111111111111111111
101000100000000010000000000000001000000000100000005
101010111110111010111010111111111011111010101011101
100010100000100010100010100000100010000010101010001
111110101111101110101111101110101110111110111010111
100000101000001000100010000010000010100000000010001
101111101111101110111010111111111110101111111111101
101000000000100010001000100000000000101000101000001
101111101110111011101111101111111011111010101011111
100000100010100010001000101000100010000010101010001
111110111110101110111110101110101110111110101010101
100000100010101000100000100010100010100010100010101
101111101010101011101010111010111010101010111110101
100010001000101000101010101010000010101010000000101
111010101111101110101010101011111110101011111111101
101010101000100010101010001000000000001000100000101
101010101011111010101011111111111111111111101110101
101010101000001010101010000000100000100000001010001
101010101110111010111010111110101110101111111011101
100010100010000010001010100000101010100010000000101
101111111010111111101010111110101010101011101110101
101000000010100000101010000010001000101000101000101
101011111110101111101011111011111110111110101011101
101010000010100000100010001010000010100010101000001
101010111010101110111010111010111010101010101111111
100010001010100010001010001000001010001010100010001
111111111010111011101011101111111011111010111010101
100010000010001000100000001000000010001010001000101
101010111011101011111111111011111111101011101111101
101000100000101010001000000010000000001000001000101
101111101111101110101011111110111111101111111011101
101000001000100000100010100000000000101000001000101
101111111010111111111110101111111110101011101110101
101000000010000010001000101000100000100010000000101
101011111111111010101010101110101111111110111111101
101000000010001000100010100010100000001010001000001
101111111010111111111110111010111111101011101011111
101000000010100000100000100010000010001000101010001
101011111110101110101110101110111110111010101010101
100010100000100010001010100000100000100010001000101
101110101110111011111010111110101111111011111111101
301000001000100010000000001000100000001000100000101
101111111010101111111111111011111111101111101011101
100000000010100000000000000010001000100000101000001
111111111110111111111111111111101010111110101111111
100010100010000010000000100000001010000004100000001
101010101011111011111010111010111010111111111111101
101000101000001000100010100010100010100000000010001
101111101111101110101110101110101111101110111110111
100000000000100000001000001000100000000010000000001
111111111111111111111111111111111111111111111111111

L
