111111111111111111111111111115111111111111111111111
100000001000000000001000001000000000001000000000001
111111101111111110101110101010111111101011111011101
100010100010000010100000101010100000001010001000101
101010111010111010101111111010111111111011101110101
101000100010100000101000000010001000001010001000101
101111101110101111111011111111101011101010111011111
101000001000100010000010001000001000101010001000001
101011111010111010111111101011101110101011101111101
100010100010001010100000001010000010101000000000101
101110101111101010101011101011111110101111111110101
100010000010101010101010001000000010100000000000101
111011111010101110111010111111101010111111111011101
101000100000101000100010001000101010001000001010101
101110101111101011101011111010111011101011101010101
100000101000001010001010000010001000101010001000101
101111111011101010111010111111101010101010111111101
101000000010001010100010000000101010001010100000001
101010111111111010111111111110101011111010111011101
101010001000000010001000000010101000001010000010101
101111101011111110101011101110101111111011111110101
100010001000000010100000101000100000000010001000101
111010111111111011111111101011111111111110101011101
101010000000001000000000001010000010000010101000001
101010111011111111111110111010111010111010101110111
101010001000000000100000100010001010100010100010001
101011101111111110101111101011101010101010111011101
101010100000100000101000101010001000101010001000101
101010101111101110101011101010111111101010111110111
101010001000101010101000101010001000101010100010001
101011111010101010101110101011101011101110101011101
100010000010001010101000101000100010001000101000001
101110111111111010101010101011101110111011101111101
100010000000100000100010101010001000100010001000101
111010111110111111111110101110111011101110111110101
101010000010000000000000100010001000000010000010101
101011111011111111111110111010111111111011111010101
101000001010000000100010001010100000001000001010001
101111101010111011101010111010101111101111101011111
100000101000100010001010100010101000101000101000001
101110101111101110111011101110101110101010111110101
101000101000001000101000100000100010100010000010101
101011101111111011101110111111111010111111111011101
101000100000100010000010100000000010001000001010001
101110111110101110111110101111111110101010101010101
101000001000100010000010001000000010101010101000101
101011111011111011111011111011111010111010111111101
101000100010001010000010000010001000100010100010001
101110101110101010111110111010101111101110101010111
100010000000100010000000001000100000000010001004001
111111111111111113111111111111111111111111111111111

U
