111111111111111111111111111111111111111311111111111
101000100000001000000000001000001000000000000010001
101010101011101111111011101011101011111011111011101
100010101000100010000010001010001000101000001000101
111110101110111010101111101011111110101111101110101
100010101010100000101000101000000010100000101010101
111010101010111011111010101111101110101011101010101
100010100010001010000010101000001000001010001010001
101110111011101010111110101011101011111010111011101
100000101010101010001000100010101010001010100000001
101111101010101111101011111110101010101110111111101
100010001010100000001000001000001010100000100000101
111011101010111111111111101011111010101111101110111
101010001010001000001000101010000010101000001010401
101010101010101110101011101010111110101011111011101
101010101010100000101010001010100000101010000010101
101010111010111111101010111110101111101010111010101
101010001010001000000010100000100000101010101000101
101011101011101111111110101111111110111010101011101
100010001010001000000010101000000000100010100010001
101110101010111011111010101011111011101110111110101
101000101010001000001000101010000010001000100000101
101010111011101111101111101011111110111110101111101
101010100000001000001000101010000010100010101010001
101110101111111010111010101010111010101010101010111
101000100010000010100010001000101000101010101000101
101011111010101111101111111111101111101010101011101
101000000010101000001000001000000010001000101000101
101111111010111011111110101111101010111110101110101
100000001010100010000000100000001010001000101010101
111111101010101110111111111111111011101011101010101
100010001010001000000000000010100010001010001000101
101010111011111111111111111010101110111010111011101
101010101010001000100000100010100000100010101010001
101010101010101010101110101110101111111110101010111
101010100000100010001010001000001000001000100010001
111010111111111111111011101111101011101011101111101
100010000000101000000010001000101000100010100000101
101111111110101011101110111010111110111110111110101
101000000010101000100000100010000000100010000010001
101011111010101110111111101011111111101010111011101
101000100010100010100010001010000000001010100010001
101110101110111010101010111010111111111010111010111
100010100010001010101010001010000000100010001010101
101110111011101010101011101111111011101110101010101
100000001010001000101000100000000010001010101010001
101111111010111011101011111110111110111010101011101
101000100010001000001010000010000010100010101010001
101010101111101111111110111011111110101010101110111
100010100000000000000000100000000000101000100000001
111111111111111111111115111111111111111111111111111

R
