111111111311111111111111111111111111111111111111111
100010000000100000000010000000001000000000001000001
111011111110101111101011111110111011111011101011101
101000001000100010101000000010100010001010100010001
101111101011111010101111111010101111101010111110111
100010001000000000100010001010100010001010000000001
101110111011111111111010101010111010101011101111111
100010100000001000001010100010001000101000100010001
101010101111111011101010111110111111101110101110101
101010101010000010000010000000100010000010101000101
111010101010111110111111111110101010111110111011101
100010101010100000001000100010101000101000100010001
101110101010111111111010101011101111101011101110111
101000100010000400100010001000001000001010000010001
101011111111101110101111111111111011101010111111101
100010000000101010001010000000100010101000100000001
101111101110101011111010101111101010101111101111101
101000001010101000100000101000001010000010001010001
101110111010101010111111101011111011111110111010111
101000100010100010100000101010001010000000100010001
101011111010111110101110101010101010111111101111101
100010000010001010001000100010101010000000101000101
111110101111101011111011101110101011111110101010101
100010100000001000001000100010100000100000100010001
101110111111111011101110111110111110101111101111111
100010100000001000101000100000100010101010000000001
101010101111111110101011101110101011101010111111111
101000100000100000101010001000101000001010100000001
101111111110101111101010101111101011111010101111101
101000000010000000100000101000001010001000100010101
101011111010111111111111101011101110101111111010101
100010000010100000100010001000101000100000000000101
111110111111101110101011101110111011111111111111101
100010000010001010001000101010001000100000000000101
101011111010111011111110101011101110101110111110101
101000001000101000001000100000100000101000100010001
101111101111101010101011111110111111101111101011101
101000101000000010101000000010001000100010001010101
101010111011111110111111111011101010111010111010101
101010001010100010000010001010001010100010101010001
101011101010101011101010101010111010101010101011111
101010100010101000101010101010101010001010001000001
101010111110101110101011101010101011111111101111101
101010100000100010101000001010001000000000101000101
101010101011111010101111111011101111111110101010101
100010001000000010101000001010000000000010000010101
101110111111111110101011101010111111111111111110101
101000000010000000100010001010100000100010000010101
101111111110111110111110111011101110101010111011101
100000000000100000000010000000001000001000100000001
111111111111111111111111111111151111111111111111111

R
