111111111111111111111111131111111111111111111111111
101000000000000010000010000000000000100000100000001
101111101111111010111011111010111110101110101110101
100000001000100010101000001010001010001010100010101
111111111010101110101111101110101011111010111110111
100000100010101000101000100010101000000010000010001
101010101111101110101010111010101111101111111011101
101010001000001000101010000010100000100010000010001
101011111011111011101011111110111110111010111110101
101000001000100010001000100000100000100010100000101
101111101110101110101110101111101111101110101111101
100010000010001000101000101000001010000010001000101
111110111011111011101011111011111010111011111110101
100000101010000010101010000010100010101000000000101
101111101010101110101011101110101010101111111011101
100010001010100010001000001000101010100000001000101
101011101011111010111111111011101010111111101110101
101000100000000010000000001000001010000000100010001
101110111011111111111111101011111011111110101011111
101010001010000000101000001000001010000010001000101
101011101110111110101011111110111010101111111110101
101000101000101000100010001000100010100010001000101
101011101011101011111010101011101110111410101011101
100010001010001000001010100010100000100010101010001
101110101010101111101010111110111111101110101010111
101000101010100010001010001000000000100010100010001
101011111011101010111111101111111110111010111111101
101000001000001010000000100000000010001010100000001
101111101111111011111010111111111011101010101011111
100000100000001010000010001010001000001000101000001
111110111111101010111111101010101111101111111111101
100010100000100010001000100010100000100010000000001
111010111010111111101010111110101110111010101111111
100010000010001000100010000000100010100010100000001
101111111111101110111111111111111011101110111111101
101000000000100010001000000000101000101000001000001
101010111111111010111010111110101110101111101011111
100010000000000010100010001000101000100010001000001
101111111111111110101111101110101011111010111111101
101000001000000010001000100010101000001010001010001
101011101110111010111011111010101110111011101010101
101000100000100010001010000010100010000010100010101
101110111111111111101010111110101011111110111010101
100010100000001000100010101000101010100000000010101
111010101111101010111010101011101010101111111010101
100010100000100010000010100010001010000010001010101
101110101111111011111110101111101011111110101110101
101000001000001010001000100010001000000000100000101
101111111011101110101011111010111111111111111111101
100000000010000000100010000000100000000000000000001
111111111111111111111111111111111111111115111111111

U
