111111111111111111111111111111111111111311111111111
101000000000100000100000001000000000000000000010001
101111101110111010111110101011111111111111101010101
101000101010000010100010101010100000100000101000101
101010101011111110101010101010101110101110101011111
100010101000000000001000101000100010001010101010001
111110101110111111111011111110111011111010101110101
100000100010101000100010000000001000001000101000101
101111101010101010101110111111111011101011101011101
100010101010001010101000101000001010001010001000101
111010101011111010111011101011101010111010111011101
101010001000000010000000001000101010100010000010001
101010111111111011111111111110101110101111111110101
100010100010001000100010000000101000101000000010101
101111101010101011101010111111101011101011111010101
100000001010101010001000100010001010100010001010101
111111111010101110111111111010111010111110101010111
100000001010100000100010000010100010001000101010001
101110101010111111101010101010101110101011101010101
100010101000101000001010101010101010100010100010101
111010111111101010111011101010101010111110111111101
100010001000001010100000001010001010000010100000101
101111101010111010111111111011111011111010101010101
100010100010100010000010001000000010000010101010001
111010111110101111111010111111111010111110101011101
101000100010001000001010100000001010001010001010001
101110101010111011111010101111101011101010111011111
100000101010001010000010001000100010101000001010001
101111101011101010111110111011111110101111111010101
101000001010000010100010100000001000100000001000101
101011111010111110111010101110101110111111101111101
101010000010100000100010101010100010000000101000101
101011101111101111101110101010111010101110101010101
101000101000001000100010100010001010101010100010101
111110101011101010101010111111101011101010111110101
100010100010001010101000000010001000001010101000101
101010111110111010111111111010111111111010101011101
101010001000100010100000001010000000100010101000101
101011101011101110101111101011111110111010101110101
101010001000101010001000101000000000100010000010001
101010111110101011111110101111111111101011111011101
101000100000101000000000100010001000001000001010001
101111111111101011111111111010101010111111111010111
101000000000000010001000000010100010001000000010101
101011111111111110101010111111111111101011111110101
100010000000100000140010100010001000100000100010101
101110111110101111111110101010101010111110111010101
101000101000100000001000101000101010000010000010001
101011101011111111101111101111101011111011111111101
100010000000000000100000000000100000001000000000001
111111111115111111111111111111111111111111111111111

R
