111111111111111111111111111111111111111111111111111
100010000000000010000000100000001000001000000000001
111011111011111010111110101011111010101111111111101
100010000010001010100010101010001010100010000010001
101110111111101010101010101110101010111010111010101
100010001000001000101000100010101010101010100010101
111011101011101111101111111010101010101010101110111
101000001010001000100010001000101010101000101000001
101111111010111011111010101011101010101111101011101
100010000010100010001000101000100010100000101010105
101110111010101010101111101011111110101111101010101
300000101010101000100000101010000000100000101000101
101111101010111110111110101110111111101110101111101
100000001010100010100000101000101000101000101000001
111111101010101010101110101011101010101011101011101
100010001010001010100010100010100010101000101010001
101110111011111011111010111110101110101110101010111
101000100010000000001010000010001010000010100010001
101011101110111111101011111010111011111110111111101
100000101000100000101010001010100010100010000000101
111110101011101110101010101110101010101011111010101
100010101010101010100010100000101000101000100010101
101011101010101010111110111111101011101110101110101
101000001000100010000010100000001010001010101000101
101111111110111011111010111110111010111010101111101
100000100000001000100010000000100010001000101000001
101110111111111110101111111111101111101110101011111
100010000000001000100000000000100000100010001000001
111011111111101011111011101111111110111010111111101
100010000000100010000010101000001000101010100010001
101110111110111110111110101010111011101011101010111
100000100010001000101000101010001010001000001000101
111111111011101011101010101011101011101111111111101
100000001000101000100010001000101000001000000000001
101110101011101110111111111011101111101011101111111
101000101000100010000010000010000000101000100000001
111011101010111011111010111110111111101111101111101
100010101010100010004010001010100000100000101000101
101110101110101110111011101010101110111110101010101
101000000000100010001010100010001010100000101010101
101011111111101111101010111011111010101111101110101
101010000000001000001000001010000010100010000000101
101110111111111010111111101010111110111011111111101
100010000000001010100010001010000010001010000010001
111011111110111010101010111011111011101010111010101
100000000010100010101010001000000000101010001000101
101111111110101011101011111111111110101010101111111
100000001000101010001000001000000010101010100000001
101111101011101110111111101010111110101011111111101
100000100000100000000000100010000000100000000000001
111111111111111111111111111111111111111111111111111

L
