111111111111111111111111111111111111111111111111111
100000100000000000100000001000001000000000000000101
111110101111101011101011101011101111111011111110101
100010101000001010001010100010100000001000100010101
101010101011111010111010111110111111101010101010101
101010101000001010101010000000000000101010101000101
101010101111101110101011101111111110101110101111101
101010101000100000001000101000000010100010100010001
101010101010111111111110101011111010111010111011101
301010100010001000000010101010001010001000100010001
101010111111111011111010101010101011101111101110101
101010000000000010001000100010100010000000101000101
141011111111111110111111111110111110111111101110101
101000001000000000100000100010100010101000001000101
101111101011101111101010101010101010101011111011101
101000101000100000001010101000101010101010000010101
101010111110111111111010101111101010101010111110101
101010000010001000100010101010001010101010001000001
101011111011101110101110101010111010101011101011111
101000001000100000101010101010101000001010001000001
101111101110111110101010101010101111111010111111101
100000100010000000101010001010100000100010100000001
101010111011111111101011111010111110101110101111111
101010001010000010101000000010000000100010100010001
101011111011101010101011111011111110111010111010101
101000001000101000101000001010000000001010001000101
101111101110101111101011111010111111111011101111101
100010100010001000001010001010100010000010001000101
111010101111101011111010101010101110111110111010111
101010100000001000100010100010100010001000001010001
101010111111111110101110111010111011101111101011101
101010001000000010100010001010100000100000100000101
101010111010111110111011101110101111111110111111101
100010100010000010100010101000100000000010000000101
101110101111111010111010101011111111111011111110101
101000001000100010001010101000000000001000001000101
101011111010101011101010101110111111101011101011101
101010000010101010001010100000100010101000101000001
101110111110101010111010111111101010101111101111101
100000100010001010001000001000001010101000001000001
111111101011111011101111101011111010101011111011111
100010001000001010100010001010001010001000100010001
101110111110111010111011111010101010111110101111101
100010101000100010001010000000101010000000101000005
111010101011101110111010111111111011111011101010101
100010101000001000001010101000000010100010001010101
101110101111111110101010101010111110101110111010111
100010000010000010101010001010100010000010100010001
101011111010111011101011101011101011111110111111101
101000000000100000001000001000001000000000000000001
111111111111111111111111111111111111111111111111111

D
