111111111111111111111111111111111111111111111111111
100010000010100000001000000000001000001000000010001
111010101010101110101110101111101111101010111010111
101010101010001000100010101000100000100010100010001
101011101010111011111010111010111110111110101110101
101000001010001010100010000010100010100000100010101
101111111011111010101110111110101110101111111011101
100000001000100010101010100000100000100010000000001
111011111110101110101010101111101111101011111111111
100010000010101000101000101000101000001000100000001
101110111010101010101111101011101110111110101111101
100000001010001010100000001000100010000010001000101
101111111011111010111111111110111010111111101010101
100010000010001010000010000000001010100000100010101
111110111010101011111010111011111011101110111011101
300000100000101000101010001000000010001010001010001
101111111111101110101011101111111110111011101010111
100000001000000010001000100010001000100000001010001
101111101111111011111010111010101011101111111011101
100000101000100000001010101000101010001000001000101
111011101010111111101010101111101010111111101110101
101010001010100010100010001000001010000000100000105
101010111010101010111110111011111011111110111111101
100010000010001010000010100010000010001000100000001
111111111111111011101110101111111010101011101111101
100000001000001000100000100000000010101010001010001
101111101011101110111111111111111111101010111010111
100000101000101000100000000010000000001000100010101
111110101010101010101111111010101111101111111010101
100000101010100010101000001000101000101000000010001
101111101110101111101110111111101010111011101111101
101000100010101000001000100000101010001000100000101
101010111010101011111011101110101011101110111110101
100010001400101010000000100010001000100010100010001
101111101011111010111110111011101110111010101011111
101000001010000010100000100010000010101010101000001
101011111010111111101110101011111110101010101110111
101010000010001000100010101010000010101010100010001
111010111111101010111011101010111010101010111011101
100010000000100010000010001010001000101010100000101
101110111111111111111010111011101111101010111111101
101010100010001000001010001010101000001000100000001
101010101010101011101011101010101111101111101111101
101000101000101010101010101000101000000010001010001
101111101111101010101010101111101011111010101010111
100000101000101010100010101000001000100010101010001
111110101010101010111110101011111110101111101011101
100000101010101000000010101010000010101000001000101
101111101110101111111010101011101010101110111010101
100000000000100000000000100000001000100000100010001
111111111111111111111111111111111111111111111111111

U
