151111111111111111111111111111111111111111111111111
100010000000000000001000000000100010000010000010001
111011111111101111101011111110111010101010111011101
101000000000001000001000100010000010101000101000001
101111111111111011111110101011101110101111101111101
100000001000001010000010101000101000100000100010001
111011111010111010101010101110111011111110101010111
100010000010100010101010000010100010000010101010001
101110111110101111101011111010101110111010101011101
100010000010101000001000100010100000100010101000101
101011101110101110111110111010111011111110111110101
101000001000101000100000001010100010000010001000101
111110111010101011111111101010101110111011101011101
100010001010101000000010101010000010100000001010001
101011111010101111111010101111111010111111111010111
101000000010100010000010101000001010001000100000001
101111111110111010111110101011101111101010101111111
101000001000101000100000101010101000001010000010001
101110111011101111101010101010101011111110111110101
100010001010000010001010100010001000100010001000101
101011101011101110111010111110111110101011101011101
101010001000101000001010100010000010001000101000101
101010111110101011111010111011111011111110111011101
101010000010101010000010000000100010000010000010001
101011111010101010111111111110101110111010111110101
101000100010100010100000000010100000100010000010101
111110101110101110101011111110111111101111111010111
100000100010101000101000000010100000100000001010001
101111111010101010111110111010101011111111101111101
101000000010101010100010001000101000001000100010001
101110111110111010101011101111101111101010111010111
100010000000000010101000100010001000100010000010001
101011111111111111101110111110111010111111111111101
101000100000000000101010100000100010000010000000001
111110101111111110101010101111111110111010111111101
100000100000001010000010100000001000100000100000101
101110111111101011111110111111101011111111101111101
101000100000001000100000001000101000001010000000001
101011101111111110101111111010101111101010111111111
101000101000001000100000000010100010001010000000001
101111101110101010111111101110111010111011111111141
100000101000100010001000100010001000100000000010001
101110101011111110111010111111101111111110111010111
100010100010000000100010000000000010000000100010101
111010111110111111101111111110111110101111101110101
100010000010100000100000100000100000100000100010101
101110111010101010111110101111101111111110111110101
100010001010101010100000100000100010000010000000101
111011101110111010101111111111111010111011111111101
100000100000000010100000000000000000100000000000001
111111111111111111131111111111111111111111111111111

U
