111111111111111111111311111111111111111111111111111
100000100000000010001000000000001000000010000000001
111110111011111110101010111111101011111010111110111
100010001000100010100010000000101010001000000010001
101011101110101010111111111110111010101111111011101
101000101000101000100010000010000010100010001010001
101111101011101111101011111011111111101010101110101
100010001000101000001000001000100000001010100000101
101010111010101010111111101010101011111010111111101
101000100010101010100000100010101010001010100000101
101111101110101110101110111110111010101110111010101
100000101010100000101000101000100010100000100010101
111110101010111111101010101011101010111111101110101
100000100010000000001010001000101010000000100010101
101111101111111110111011111110101111111110101010101
100010001000000010100010000000100000001000101010101
111011101011111011101110111111111010111011101010101
101000101000101010001000100010001010001010001010101
101110101110101010101011101010101111101010111010101
100010101000100010101010001010100000001010001010101
101110111011101110101011101010101111111011111011101
100010100010101000101010001000101000001000001010001
111010101110101110111010101111111011101111101010111
100010101000100010000000101000000010000000001010001
101010101011111011111011111011111111111111111011101
101010101010001000001010000010000000000010000010001
101110101010101111101110111110111111111011111010111
100000101000100000101000100000100000001000001000101
101111101011111011101011101111101111101111101011101
101000001000001000101010001000000010000000101000101
101011111111101110101010111111101011111111101110101
100010000010001010001000000000101010001000001000101
111110111010111011111111111110101010101011111011101
100000100010000000000010001000101000101000100000101
101111111011111111111010101011111111101110111110101
100000001000100010000010101000000000000010001000001
101111101110101010111110111111111110111110101111101
100000100010101000100000000000100000100010100000101
111011111011101111111111111010101111101010111110101
100010001000101000000000001010001000101010100010101
101110101110101111101111101111111010101011101010101
101010100000100000001010001000100010001010001040101
101010111110111111111010111010101111111010101111111
100010000010100000000010001010001000001010101000001
111011111011101111111011101011111011111010111011101
101000001000001000001010001010000010000010000000101
101111101111111011101010111011101110111111111111101
101000101000000000101000100000101000100000100000101
101010101111111111101111111110101011101110101110101
100010000000000000000000000000100000001000001000001
111111111111111111111111111111111115111111111111111

L
