111111111111111111111111111111111111111111111511111
101000000000000010000010000000000000100000000000001
101011111011111010111011101110111111101110111111101
101000001010001000100000001000100010001010001000001
101111101110101111101111111111101010111011101111101
101000100010100010001000100000001000100010001000101
101010111010111011111010101111111111111010111010101
100010001000001000000010100010000010000010000010101
111111101011111110111110111010111010111011111110101
100000001010000010100010000010001000101010100000101
101111111110111010101010111111101111101010101111101
101000001000100010101010000010001000001000101000101
101011101011101110101011111010111111101011101011101
100010101010101000101010001000100000100010001000001
111110101010101111101011101110101110111110111011111
101000001010000000101000100000101010100000101010001
101011111011111110101110111111101010101111101010101
101000101000100000100010100010001000001000000010101
101110101010101111101010101010101111111011111110101
100010100010100000101010001000101000001000100000101
101010111110111110101011111111101011101111101111101
101010001000100010101010000000001010101000000000101
101011101011101110101010111111111010101011111110101
101010001000101000101010100000001010101010000010101
101110111110101011111011101111101010101010111011101
101000100000100000001000101000100000100010100010001
101011101010111111101110101110111111111010111010101
101010001010100010000010000000100010001010001000101
101011101011101011111011101111101010101111101111101
101000101000101000100000101000101000100000101000101
101110111010101110111110101010101111111110101010101
100010001010100010001010101010001010000010101010101
101111101110101111101010101011111010111410101011101
100010001000101000101000101010100000100010001000001
101010111011101010101011101010101111101011111011111
101010001000001010101010001010001010001000001000101
101011101011111010101011111010111010111111111110101
101000101000001010001000001010100010100000000000101
101010101111111011111111101010111010101111111111101
101010100000001010001000100010001010101000000000001
111010111111101011101010111111101010101110111111101
100010101000101000101010000000100010100010000000101
101110101010101010101010101111111010111011111110101
101000001010001010100010101000001010000010001000101
101110111011111110101110111011101011111110101011101
100010100010000000101010000010001010000000100010101
101011101111101111101011111110111010111011111110101
101000001000101000001000000010001010100010000000101
101111111010101011111011111011101011101110101111101
100000000010001000000010000000100000001000100000001
111111111111111111111111111111111111111111111311111

D
