111111111111111111111111111111111111111111111111111
101000100000100000000000000000100000100000000010001
101110101010111111111010111110111010111111101011101
100010101010000000001010100010000010000000001010001
111010101011111111101010111011111111111111111010101
100010101000000010101010100010000000000000001000101
101110101111111010101110101110111111111011111111101
101000100010000010100000100010000000001000000000101
101010101110111110111111111011111011111011101011101
101010001000100000100000001010000010001010001010001
101111111011101110101110101010111110101110111110111
100010001010001010001000101000100000100000100000101
111010101010111011111011101111101111101111101111101
100010101010000000100010100000001000101000001000001
101110101011101111101110111110111010111011111110101
100000100010001000001000000010100010100010000010101
111111111111111011111011111110101110101110111010101
100000100000000010000000000000101010001000100010101
101111101011111011111111101111101011111110101110101
100000001000001010001000100000101000000000100000101
101111111111101110101010111111101011111111111111101
100010000010100000100010000000001010000000000000101
111010101010111111111111111111111011101011101111101
100010101000001010000000001000001000101000101000103
101110101111101010111110101011101110101110111010101
101000101000101000100000100010001040101000100010001
101011101110101111101111111110111011101010101111111
101010001000100000100010000000000010001010100000001
101110111010111110101011111111111111101010101111101
500000100010100000101000000000000000101010101000101
111111101110101111101111111111111010111011101010101
100000100010100000101000101000001010001000001010101
111010101010111110101010101011101111101111111010101
100010101010001010100010101010100000100000000010101
101110111011101010111110101010111110111011111010111
101000000010100010000010001010000010001010001010001
101111111110111011111011101010111011101010101111101
100010001000001010001010001010100010001010101000101
111010111011101011101010111010111010111110101010101
100010100010001000101010100010001010000000100010001
101110101110111110101011101111101011111111111111101
100010001010000000001000001000001010001010000000001
101011101011111111101111111110111010101010111111111
101000101010000010001000100000100000100010001000001
101110101010111010111110101011111011111011101111101
101010100010100010000000101010001010001000100000001
101010111010101111111110101010101110101110111111101
100010001010100000100010101000101000100010001000001
111011101110111110101011101111101011111011111011111
100000100000000010001000000000100000001000000000001
111111111111111111111111111111111111111111111111111

L
