111111111111111111111111111311111111111111111111111
101000100010000000001000001000001000000000100000001
101110101010111110111010111011101011111010101110101
101000101010000010100010001000101010100010100010101
101011101010111110101111101110101010101111111010101
101000001000100010000000100000101010100000000010101
101011111111101011101111111110101010111111111110101
101000001000001000101000000010100010100000001010101
101111101011111110101011111010111110101011101010111
100010001010100010101010001010100010001010000010001
111011111010101010111010111010101011111011111111101
101000001010001000000010100010101010000010001000101
101111101011111111111110101110101010111110101010101
100000001010000000001000001000101000100000100010101
101111111010111111101011111110101110101111111110101
100000101000100000101000000010001000101000100010101
111110101011111110101111111011111111101010101010101
100010100010000000101000001000001000001010001000101
101010111011101011101010111111101011111011111111101
101010001000001010001010100000100010001010000000101
101111101111111010111010101011111110111010111110101
100000100000100010001010001000000000100010001000001
101110111110111111101011111111111110101111101111111
101000100000100000101000000010001000101000001000001
101011101111101110101111111010101011101110101011101
101000001000001000101000001000101000100010101010001
101111111010111110101010111111101110111010111010111
101000100010000010001010000000101000100010000010001
101011101111111011111011101111101011101110111111101
101000101000001000100010100010001000101010001010041
101010101011111110101110111010111110101011101010111
101010000010000010100010100010001010101000100010001
101111111010111010111010101011101010101011111011101
100000100010100010001000101000101010101000000010001
111110111110101111101110101111101010101111111110111
100010001000100000001000101000001010001000000010001
101011101011111111111011101011111011111011111011101
101000100010000000100010001000001000000010000000101
101011111111101111101110101111101011111111111110101
101010000000001000001000101000101000001000001010001
101110111110101011111011111010101011101011101011101
100000100010101000001000000010101000100010001000101
111111101010101111101111111110101111101110111011101
100000001000100000100010001010101000101000101000101
101111111111111110111010101010101010111011101010101
100000000000100010001000100010101010000010100010001
101111111110101011101111101110101011111110101111111
100010000010101010000000101000100010100000101000101
111011101010101011111111101011111110101011101010101
100000001010001000000000001000000000001000000010001
111111111111111111111111111111151111111111111111111

L
