111111111111111111111111111111111111111111111111111
101000100000100000100000000000100000000010100000101
101010101110101110101111101111101011111010101010101
100010101000001000100000100010001010001000101010101
111110101111111011111111111010111010101110101010101
100010100000100000000000100010101010100000101010101
101010111110111111111110101010101010111111101010101
101010000010000000001000001010001010001010001010101
101011111010111111101111111011101011101010111010101
101000101010000000100000100010001010000010101010101
101010101011111111111010111110111011111110101010101
101010001000000000001010000000001000100000001010101
101011101111111111101011111111111110101111101010101
501000100000000000101010000000100010001000101010001
111110101111111110101010101111101011111010101011101
100000101000100010101000101000101010000010101010001
101110111010111010101111111010101010111110111010111
101000100010001000100000000010001000100010001010001
101110101111101011111111111111111111101011101011101
100010100010001000100000001000000000101000001000101
101010111010111110101110101111111110101111111010111
101010001010001000101010100000000000101000001010001
111011111011101111101010111111101111101011101110101
100010000000101000101010000000101000001010000010101
101110111111101010101011111110111011111011111010101
101000100010001010100000001010000010001000001010101
101011111010111010111111101011111110101011101010101
101000000010000010000000100010000010101010101010101
101111111011111111101011111010101010101010101011101
100010100010000000101000001010101010101000101000101
101010101110111110111110101010101110101110101110101
101000100010000010100000101010100000100000101010001
101111111011111010101111111010111111111111101011101
100010000010001010001000100010100000000000101000001
111010111111101011111010101110101111111110101011111
100010100000001000001010101000100000100010001000001
101010111110101111101010101111111110101011111111101
101010001000101000100010100000100010101010000000101
101011101011101010111110111110101010101110111110101
101010001000101010000010001000101000100000001000101
101110111010111011111011101011101111101111111011101
101000100010000000100000101000001000000000100010003
101011111111111110101110101111111111111110101010111
100010001000000010100010100000000000000010101010041
101110101011111010111010111110111111111011101011101
100000100010100010001010001010100000000000001000101
111111111110101111101011101010101111111111111111101
100010000000101000101010101010101000000000100000101
101010111011101010111010101010111011111110101110101
101000001000000010000010000010000000000010000010001
111111111111111111111111111111111111111111111111111

D
