111311111111111111111111111111111111111111111111111
101000000000000010000000000010000000000000100000001
101110111111111011111110101010111011111110101011101
100000101000001010000010101010001000100010101000101
111111101010111010111011101011111110111010101110111
100000100010000010001000001000000010001010100010001
101111101111111110101111111111111011101010101111101
100000101000000000100010000010000010001000101000001
101110101011111111111010111110111110111110111011111
101000101000001000000010000000101000000010001000001
101010101011111011111110111111101011111011101111101
101010101010000010000010100000001000100010100000101
111010101110111111111010111110111011101110111110101
100010100010100000000010000010000010001010000010101
101110111010101110111111111011111110111010101110101
101000001000100010001000001000000000101000100010101
101111111111111011101011101111111111101011111010101
100000100000001000100010101000000000001010001010001
101110101110111110111110101011111011111010101011101
100010101010001000000000100010001000001000101000001
111010101011101011111111111010111111101111101111111
100010001000101010100010001000100000100000100010001
101111111011101010101010101111101110111010111011101
101000000000100010101000101000001000000010100010001
101111111010111110101111101011111110111111101110101
100000001010000000100000100010000010100000001000101
111111101010111111111110111110111011101111111010101
100000101010000010000010100010101010001000000010101
111110101111111010101110101010101010111111111110101
100000100000001000100010001000001010000010000010101
101011111111101111111011111111111011111010111010111
101010000000000000000000100010000000100010100010001
101110111111111111111111101010111110101110111010101
100010100000001000100000001000100010101000001010101
111010111011101010101111111111101110101111101011101
100010001010001010001000000000000000100000001000101
101011101110101011111111111111111111111111111110101
101000100000101010000000001000000000000010001000101
101111111111101010111111101011111110111011101011101
100000001000101010100000101010001010401000001010001
101111101010101010101111101010101011101111111011101
100010101010101010100010001010100000100000100010001
111010101010101010111010111010111110111110101110101
101010100010101000100010100010001010001000101000101
101010111110101111101010101111101011101011101011101
101010000010001000001010001000001000101000001000101
101011111011111011111011111110111011101111111110111
101000000010000010001010000000101000100010000010001
101111111010111110101011101111101010111010111011101
100000000000100000100000001000000010000000100000001
111111111111111111111111111111111111111511111111111

L
