111111111111111111111111111111111111111111111111111
100010000000100000000000000000001000001000000010001
111011101110101111111111111111101011101010111110101
101000001010001000001000000000101010001010100000105
101111111011111010101011111011101010111010101111101
100000100000001010101000100010001010000010001000001
101011101110111010101010101110111011111111111011101
101000101000100010101010100010101010000000100010001
111110101011101110101110111110101010111110101111111
100010001010001000100010001000101010101000100000001
101011111010111011111011101011101010101011111111101
101000000010100010001010001010000010101000000000101
101111101110101110101010111011111010101111111110101
101000001000101010101010001000001010001000100000101
101011111011101010101011101111101011101110101110101
101010001010001000101000001010001000100010100010101
101010101010111011101111101010111110111010111011101
101010100010001000100000101010001010100000100010001
101110111111101110101111101011101010101111101110101
100010100000100010100010000000101010101000001004101
101010101110111010111010111111101010111011111011111
101000101000000010001000100000001010001010001000001
101111101111101111111110101111111011101010101011101
101000100010001000000010101000000010001010101000101
101110111011111011111011101011111010111010101110101
100000001000000010001000101010100010100010100010101
111111101111111110101110101010101010111010111010101
100000101000001000101000101010101010000010100010101
111010101110101110111011101010101110111110101111101
100010100010100010001010001000100010100000100000001
101111111010111011101010111111101010101111111111101
100000001000101000101010000000101010100010100000001
101111101111101110101011111110111010111010101111111
101000100000101000101000100010001000100010001000001
101010111010101011101011101011101011101110111011101
100010001010001000101000001000001010001010001000101
111111101011111110101111111111111110111011101010111
301000001010001000101000000000000010100000101010001
101011111010101011101011111110111010111010101110101
101010001000100010000010000010100010001010000010101
101010101111111110111111101110101110101111111011101
101000100010001000100000001000100010100000001000001
101111111010101011101011111011111010111111101111101
100010000010100010001010001000001010001010001000001
101110111111111011111010101011101011101010111011111
100010000000001000000010101000101000100010101010001
111011111111101111111110101111101110111010101010111
100010001000100010001000100000001010001010101010001
101110101010111010101011111111111011101110101011101
100000100010000000100010000000000000000000100000001
111111111111111111111111111111111111111111111111111

U
