111111111111111111111111111111111111111111111111111
100010000010001000000000000000000010000000000010001
111011101010101111111110111011111110111111101010101
101000001000100000100010100010000000100010001010101
101111111111111110101010111110111111101110111010101
100000000000100010001010000000100000001000101000101
101110111110101111111010111111111110101011101111101
101010100010100000001010000000000000101000101000001
101010111010101110111011111111111011111110101011111
100010001010101000100010001000000010001000100010001
111011101010101011101110101110111110101011101110101
100010001010101000100000100010100010101000100010101
101110111010101110111111111010101010101010111010101
101000100010100010000000100010001010101010101010103
101011101010111110101111101111111010101010101010101
101010001010001000101000101000001010101010101010101
111010101111101011101010101010111010101110101011101
100010101000101000101010001010000010100000101000001
101110101010101010101011111011111110111111101111101
100010101010001010101000001000001010001000000000101
111010101011111110101111101111101011101111111011101
100010101010000000100000101010001010001000000010001
101110111010111111101111101010111010111011111110111
101010000010100010001000001000100010001000000000101
101010111110101110111011111011101011101111101111101
101000001000100000001010000000001000100000100010001
101111101010111111101011111111111110111110111011101
100000101010100000101000001000000000100010101000101
101110101010101110111111101011111110101110101110101
101000100010100010000000101010000010001000100010101
111010111111111011111010101110111011111011101010101
100010100000100010100010100000101000000010001000101
101111101110101110101110111111101111111110111111101
100010001010001000100010100000000010000010140000101
101010111011111010111010111011111110101010101110101
101010100000000010001010000010000000101010001010101
101010111110111111111011111010111111101011111010101
101000100010000000001000001010100000101000100010001
101111101010111111101111101010101111101110101011101
100010001010000000100010101010100000101010001000101
111010111010111111101010101110111110101010111111101
501000101010100000001010100000100010101010100000101
101111101011101111111010111111101010101010101110101
100000001010001000000010000000101000101000101010101
101111101010111111101111111010101111101111101010101
101000100010000000100000100010100010001000100010001
101110111111101110111110101110111010111010111011111
100000100000101000100010001010001010000010100010001
111110101110111011101111111011101011111110101111101
100000001000000010000000000000000000000010000000001
111111111111111111111111111111111111111111111111111

R
