111111131111111111111111111111111111111111111111111
100000100000000000100010000000001000001000000010001
111110111011111110101010111011101010101110111011101
100010001000001010101010100010101010100000101010001
101111101011101010101110101110101110111111101010101
100000001000101000001000100010100000100000001000101
101111111111101111111011111010111111101110111111101
101000000000101000001010001010000010001010100000101
101110111010101011101011101011101011101010101110101
100010100010100010101010001010001000001000101000101
111011101110101110101010101010111111101111101011101
101010001000100010101010101010001000001000101000001
101010111011111010101010111010101110111010101111111
101000101010001000101010100010100010100010101000001
101111101010101110101010101111111010101110101010111
100010001010100000100010101000001010101010001010001
101110101011101111111110101011101011101011111111101
100000101000100000000010100000101000001000000000101
101111101110111111111010111111101011111011111010101
101000001010100000001000001000001010000000100010001
111011101010101111111110111011111011111110101111101
100010000010100000100010100010001000001010101000101
101110111110111110101010101110111111101010101010101
100010001000100010001000100010100000101000101010001
101011111011101011101111111010101010101111101011111
101000001000001000101000000010101010101000001000101
111111101111111110101011111110101010101011111110101
100000001010000000101000100000001010101000001000101
101111101010111111101110101111111011101110101110101
101000100010001000101010100010001000100010100010001
101110101111101110101010111011101110111011101011111
100010101000100010101010100000100010001000101010001
101010101010111010101010111110101111101110101010101
101010001010001010000010000010101000100000101000101
101010111010111011111111111010101010111111111011101
101010100010000010000400000010100010000000001010101
111010101111111110111111111110111111101111101010101
100010100000001000100010001000100000001010001010101
101111111111101011101010101011101111111010111010101
101000000000101010001010101000001000000010001000101
101011111110101010111010101111111010111111101110101
101010001000101000100010101000100010000000101000101
101010101011101111101110101110101111111110101011101
101010101000100000100000100010001000001010101010001
101010111110111110111011111010111110101010101110101
101010000010000010001000001010000000100010001000101
101011101011101111101111111011111111111011111011101
100010001000100000100010001000001010001010000010001
101110111110111011111010101111101010101011111010111
100000100000001000000000100000001000100000000010001
151111111111111111111111111111111111111111111111111

L
