111111111111111111111111111111111111111111111113111
101000100000100000000000100000001000001000000010001
101011101110101011111111101110101110101010111010101
101000001000101000000000000010101000101010100010101
101110111011101111111111111110101011101110101110111
100010100010001000001000000014101000100000101000001
111011101110111011101011111010101110111111101111101
101000100000001000100010001000100000100000100000101
101110101111111110111110101111101111101111111110101
100010100010000000100000100000101000101000000010101
101010111110101111101111111110101010101011111010101
101010100000101000101000100010101010100000001010101
101110101111111010101010111010111010111111101010101
101000101000000010100010001010001010001000001010101
101011101011111110111111101011101011101111111010101
101010001000100010000000001010001000100000001010101
101010111110101011111111111010111110111111101010101
100010001000101000001000000010000010000010001000101
101111101011111110101011111011111010111110111011101
101000001010000010100010001000001000100000101000101
101110101011101011101110101110101111101111101110101
100010101010001000101000100010100000101000000000001
111010111010111110111011111010111011101011111111111
101010001010100010000010000010001010001000100010001
101010101010101011111111111011101110111110101010101
100010100010001000000000001000100010100010101000101
101110111110111111111111101110111010101011101111101
101000000010000000000010001000000010101000100010001
101111111011111111111010111111111110101110101110101
100010000010000000001010000000100010100010001000101
111010111110111111101111111110101010111011111011111
101010001000100000000000100000101000001010001000001
101011101011101111111110101111101011111010101111101
101010001010000010000010101000101010001010101000101
101010111011111110111010101010101010101010101010101
100010000010000010100010101010001010100010100010101
101110111110111010101110101011111010111111111110101
100010100010100000100010001010100010100010000000101
111011101010111111111010111010101110101010111011101
101000101010000010000010100010001000101000100010001
101110101011111011111010101111111011101111101110101
100010001000001000001010100000001000100000101000101
101011111111101011101011111111101110101110101011111
101000000010001000101000000000100010101000101000001
101111101010111111101111111110101010111011111111101
101000101010100000101000000010101000001000001000001
101011101010101110101011101110111111101111101011101
101000101010101000101010100010000010000000001010001
101110101110101011101010111011111011111111111010111
100000100000001000001000001000000000000000000010001
111111111111111111111111111511111111111111111111111

D
