111111111111111111111111151111111111111111111111111
101000000000100000000010001000000000100000000010001
101111111010111111101010111011111011101110111011101
101000000010100010001010000010001010001000100000001
101011111110101010111011101110111010111011111111101
100010000010001010101000101000100010101010000010001
111110111011111010101110101011101110101010111011101
101000001000101010101000101000100000001010101000101
101011101110101010101011101010111111111010101110101
100010001010001000100010101010001000100010000010101
101110111011101111101110101111101010101011111010111
100010100010000000101000101000001010001010100010001
111110101010111110101011101011111011111010101111101
100000101000100010101000000010000010000010100000101
101111101111101010101111111110111110111110101111101
100000101000101010100000000010100000000000101000001
101110111010101011111111111010111110111111101011101
100010000010001010001000000010000010100010001000101
111011111110111010101011111110111011101010111110111
100010100010001010101000000010001000001000000010001
101110101011111010101111111010111111111111111111101
101000101000000010100000101010100000001000000000001
101110101111111110111010101011101111101011111111101
100000100000000000100010001000001000101010000000001
101111111111111011101111111111111011101011101111111
101000001000001000100000000000100010001000101000001
111011101011101111111011101110111010111110101011101
100010000010001000001010001010000010100000100010001
101110111111101011101110111011111010111011111110111
100010100000101010101000100000000010000010000010101
111011101110101010101011111111101111111111101010101
100010001010100010001000001000100000000010001010001
101010111010111110111011101010111111111010101111101
101010000010000010101010001010004000001010101000001
101110111111111010101010111011111111101010101011111
101000100000000010100010100010000010101010101010001
101011101111111110111110101110111010101010101010111
100010001000000010001000100010001010101000101010001
101110111111101111101011111011101010101011111010101
101000100000001000101000001010001000101010000010101
101011101111101010101110111010111011101110111111101
101000101000001010100010001010001010001000100000001
101110101011111010111011101010101010101011101111101
100010101000100010000000001010101010101010001010001
111010101111101111111111111010101010111010111010111
101010100000000000100000000010101010001010101000101
101010111111111111101111111111101011101010101011101
101010100010000010001000000000001000101010101000101
101010101010111010111111101111111110101010101110101
100010001000001000000000001000000000100000100000001
111111111113111111111111111111111111111111111111111

R
