111111111111111111111111111111111111131111111111111
100010000000100000100000000000100000101000000000001
111010111110111110101111101010111010101011101111101
101010100010000010001000101014000010001000101000001
101010101011111011111010111011101111111110101110111
101010001000100000001010100010001000001000100010101
101011111110111111101010101011111011101011111010101
101010001000100010000010001010001010101010100010101
101010101011101011111111101110101010101010101110101
101000101000101000100000001000100010100010101000001
101111101110101110111111101011111110111110101111101
100010001000101010001000101010000000000000100010001
101010111011101011101010111011111111111010111011101
101000100000001000100010000010000000001010101000101
101111101111111011111111111110111111101010101110101
100010100010000000001000100010001010001010000010101
111010111010111110101010101010101010111011111110101
101010100010100000100010101000101010100010000000101
101010101111101111111110101111101010111010111111101
101010100000100010000010101000001010100010000010001
101010111110111011111010111011111010101011111011111
101010000010001000001000000010000010001010001000001
101010111111101011101111111111111011111011101111101
101010000010001000100010000000000010000000001000101
101010111010111110111011111011101110111111111010101
101010101010001000100010000010101000100010000010001
101010101011101111101110111110101011101010101111111
100010001000100000001000101000001000101000101000001
101111111010111111111010101011111110101111111011101
101000000010100000000010100000100000100000000000101
101010111111101111111110111110101111111111111111101
101010000000000000000010000010100000000000001000101
101111111011111111111111111011111011111111111010101
100010001000100010000000100010000010001000100010101
111010101011101010111110101110111110101010101110101
100010101010001010100000100000101000100010001010101
101110101010111010111110101111101011111111111010101
100000101010100010000010101000001010001000001000101
111111101010101111111010101110101011101011101011101
100000101010101000000010100010101000100010001000001
101110101110101011111110111011101110111010101111101
101000100000101000000010101000100010001010101000101
101011111111101110111010101110101011101010101011101
101010000000100010100010100000001010001010100010001
101110111011111011101110111111101110111110101110111
100010001000001000100010000000101000100000101000101
111011101111101110111011111110111011111011101011101
100010001000100010001010000010100010000010001000001
101110111010101111101010111010101110101111111111101
100000000010100000000010001000001000100000000000001
111111111111111111111111111111111111151111111111111

U
