111111111111111111111111111111111111111111111111111
100010000010000000100000001000000000100000100000101
111010111010111010101110111010111110111010111010101
101010101000100010100010000010001000001010000010101
101010101111101110111111101111101111101011111110101
101010000000100010000000101000100010101010100000101
101011111111101011111110111010101010101010101111101
101010001000101000001000100010101010000010000000101
101010101010101111101011101110111011111111111110101
100010100010101000101000001010001010000000100010101
101110111110101110101111111011101010111110111010101
100000100000100000101000001000001010000010100010001
111111101111111110101011111011111011111010101111101
100010100010000000101000100010000000001010100000001
101010111011111111101110101110111011101010111111101
101000001000100000100010101000001010001010000000101
101111101110101110111010101111101010111011111110101
100010101010101000000010001000101010001010001000101
111010101010101111111111101010111011111010111011101
300010000010101000000000100010001010000010001010001
101111111110101011111110111111101010111111101011101
100000001000100010000010000010101010001000001000101
101111101011101111101011111010101011101010111110101
101000100010100000101000101010001010000010100000101
101011111110111110101110101011101010111110101111101
101000000010000010101010001000101000100010101000001
101111101010111110101011101110101111101011101111111
101000001010000010101000001000100000001000100000001
101011111010111010101111111011101111111110101111101
100010001010101010100010000010001000000010101000101
111110101010101010111010111111111011111010111010101
101000140010001000000010000000000010000010001010001
101011111110111111111011111111111110111111101011101
100010000010100010000000001000001000100000001000101
101111101011101011111111101111101011111011111110101
100000101000001010000010000000001000001000000000101
111110101111111010111011111111101111101111111111101
101000101000000000101000100000000010101000001000001
101011101111111111101110101111111010101011101011111
101010000000001000000010100010001000101000101000001
101010111111101111101110111110101110101111101111101
101010100010001000100010000010101000101000000010005
101010111010111010101011111010101011101011111110111
100010000010001010101000001000101000101010000010101
101111111011101010111110111111101111101010111010101
100000001000100010100000100010001000001010001010101
111111101110111110101111101010111011111010111010101
100000001000001000100010001000100010100010100010001
101111111111111011101010111111101110101010101111101
100000000000000010001000000000001000001000100000001
111111111111111111111111111111111111111111111111111

U
