111111111111111111111111111111111111111111111111111
101000000000001000000000100000100000000000001000001
101111111011101110111110101110111111101111101011101
100000000010100010000010100010100000001000100010101
111111111110111011111010111010101111111010111110101
100000001000001000100010100010100000100010100000001
101111111010111110101110101110101110101111101111111
101000000010000010001000101000100010101000001000001
101011111111111011111011101011111110101011111111101
101010000000101000000010001000000000101000100000101
101010101110101111111110101111111111101110101010101
101010101000100010000000101000100000000000101010001
101011101011101010111110101010101111111011111011101
101000101000001010100010101010101000001000000010001
101110101111111011101011101010111011101111111110111
100000100010001000001000100010001010100010000010001
101111111010101111111110111111101010111011101011101
101000000010100000100010000000100000001000101000001
101110111110111010101011111110111111101110111111111
100000100010100010001000100010001000000010000000003
111111111010101111111110101011101111111011111111101
100000000010101000001000001000100010001000000010001
101111111010101011101111111011111010101111111110101
100000101010101000100000001010001000100000001000101
101110101010101110111111101110101111111111101011101
100010100010100000001000101000100000100000001000101
111110101110111111111010101011101111101111111010111
100000101000100010000010001000100000001000100010001
101111111011101010111111101110111111111010101111101
100010001000001010101000001010100000100010100000101
111010101011111110101011111010111110101011111110101
100010101010000010101000000010100000101000001000101
101110101010111010101011111110101111101110111011101
500000101010100000100010000010100000100010000010001
101111101010111111111110111010111110111011111110101
101000001010000000000010100010001000101000000010101
111010111011111111111010101111101010101110111110101
100010100010000010000010100000101010001000100000101
101110101110111010111110111110101011101011101111101
101000101000001010000410100010101010001010100000101
101011101111101111111010101110101011111010111110101
101000100000001000000010101000101000001010001000101
101111111111101011111110101011101111101010111011111
100000001000001010000010101000001000100010001000001
101111101011111010111010101111111010101111101111101
100000100010000010001010001000001010101000000000101
111110111110111111101011101110101010101110111111101
100010001010001000101000100000100010100000100000001
101011101011101010101011111111111110111111101111101
101000000000100010001000000000000000000000001000001
111111111111111111111111111111111111111111111111111

L
