151111111111111111111111111111111111111111111111111
100000100010000000000000001000000000100000001000101
111110101110111011111011111011111010101111101010101
100010100000001000001010000010000010001000101010101
101010111111111011101110111110111111111110101010101
101010000000001000100000100000100000000000100010101
101011111111101111101111101111101011111111111110101
101010001000001000101000001010001000000000000010001
111010101011111010111011111010111111111111101111101
100010101010100010000010000010100010000000100000101
101110101010101011111110101110101110111011111011101
101000101010001000000010101000100000001000001000001
101011101011101111111011101011101111111111101111111
100010001000100010000010001000101000000000001000001
111110111110111110111110111110111011111111101011101
100000100000100000100000100000100010000010100010101
101111101111101111101110101111101111101010111110101
101000100010001000001000101000001000001000001000101
101010111010111011101111101010111011111110111010101
100010001010101010001000001010100000100000100010101
101110111010101010101011111110101110101111101110101
101010001000101010101000100010101000100010001010101
101011101111101010111110101010111010111110111010101
101000100000100010001000101000100010100000100010001
101011101110111110101011101111101110101111111011111
100010001010000010101010000000100010100000001000001
111110111011111010101011111110101010111111101110101
100000100010000010101000000000101010100000100010101
101111101110111111101111111111111011101010111010101
100010000010000000000010001010000010001010100010101
101010111011111111111010101010101010111011101111101
101010001010000010000000100010101010101010001000001
101011101010111010111111111110101010101010111011101
101010001010101010100000001000101010101000101000101
101011111010101010101111101011101110101111101010101
101010001010001000100010101010100000100000000010101
101010101011101111111010101010111111111111111010111
101000101000001000001010100010001000000010001010001
101111101011111010111010111110101110111010101111101
101000001010000010000010001000100010101010100000101
111011111010111111111110111010111010101010111110101
100010000010101000000010000010100000100010001010101
101110111110101011101110111110111111101111101010101
101000100000101000100000000010000010100000101010001
101011101111101110111111111111111010111110101011101
101000101000000000100000000000000010000010001000001
101111101111111111101111111111111110111111111011111
101000001000100000001000001000001000000000001010001
101011111010101111111010111010111411111110111010101
100000000010001000000010000010000000000010000000101
111111111111111111111113111111111111111111111111111

U
