111111131111111111111111111111111111111111111111111
100010000010001000000010000000001000000010000000001
111010111110101011111010101111101010111110111110101
101010000000100010001000100000101010000010000010101
101010111111111110101011111110101011111011101110101
100010100010001000101000001000101000101000101000101
101110101110101011101111111011101110101110101011111
100010001000100010100000001000100010000010001000001
111011101011111110111111101110111110111111111111101
100010001000001000001000100010000000100000001000001
101110111111101010111010111010111111101111101011101
101010000000101010100010000010100014001000101000101
101011111011101011101111111111101010111010101010101
101000100010001000000000001000001010100010001010101
101010101110111011111111101011111010101111111010111
101010001000100000100000100010001000100000001010001
101111101011101111101110111110101111111111101011101
101000101010000010001010100010101000000000101000101
101010101011111010111010111010101011111110101111101
101010101000001010000010001000101010000000101000001
101010101111101011111011101110101010111011101011111
100010101000101000001000100010101010100010001000001
111110111010101111111110111011101010111010111011101
100010000010100010000010101000100010001010100010001
101011111110111010101010101110101111101010111110101
101000000010001000101010001000101000001010001000101
101111111011101111101111101011101011111111101011111
101000100000100000101000101000101010001000101000001
101010101110111110101010101110111010101010101011101
100010101010100010100010001010001000101010001010001
101111101010111010101111101011101011101011111010111
101000001000000010101000100010001000100000001010001
101011111111111010101010111110111011111111101011101
101010000000001010101010000010100010001000101000101
101010111111101010111011111010111110101010101111101
101010100000101010100010001010100000101010100000001
111010111011101010101110101010101111101010111111101
100010100010001010101000101000100010001010001000101
101110101010111110101011111011111010111111101010101
100000101010000000101000000010001010000000100010001
101111101111111111101111111010101011111110101111111
100010100000000000001000001010100010000000100000101
111010101111111110111011101010111110111111111110101
100010001000100010000010001010001010001000000010101
101110111011101011111110111111101011101011101110101
100010000010001000000010000000100010001010001000101
111011111110111111111011111011111010111011111011101
100010000000100010001010001000000010001000001000101
101110111111101110101010101111111111101011101110101
100000100000000000100000100000000000001000100000001
111111111111111111111111111111111111151111111111111

D
