111111111111111111111111111113111111111111111111111
101000000000000000000000100000000010000010000000001
101111111110101111111110101111111011101011101110101
100000000010100000100010001000001000001000100010101
111111111010111110111011111011111111111110111110111
100010001010000010001000140010000000000010000010001
101110101011101111101011101010111110111111111010101
101000101000101000101000001010000010000000001010101
101011101110111010101011111011111011111111101010101
100010100000100010001010100010100010001000100010101
101110111111101111111010101010101110101010111110101
101000000000001010000010101000101000101010000010101
101011111111111010111110101111101011101011101110101
100010000000100010100000100010001010001010001000101
111110101110101010111011111010111010111110111011101
101000101000001010001000001000100010000010000000101
101011101011111011101010101111101011111011111111101
101010001010001000101010101000101000101000000000001
101010111010101111101010101010111110101111111111101
100010100010100000001010100010000000100010001000001
101110111010111111111110101111111111111010101011111
101010001010000010000010101000000000001000101000101
101011101111111010111010111011111111101011101110101
100000100010001010101010100010001000101010101000001
111110111010101010101010101110101010101010101011111
100000001000101000100010100010101010101000100010001
111111101111101111101110111010101110101111111010101
100000101010001000001000000010100000101000001010101
101110101010101011111111111010111011101011101110101
101000101010101000100000001000101010001010100000101
101011101010111110111011101111101010111010111111101
101000100010000010000010101000001010000010000010001
101110111110101111111110101010111011111111111010111
101010000010101000000000101010000000000000000010001
101011111011101011111010101111111111111111111011101
101000001000100000001010100000100000000010100010001
101011101110111111111010111110101111111010101110101
101000100000000000000010000010001000000010001000101
101111111111111111111111111011111011111111111011101
100010001000001000100000001010001000100000001000101
101010101011101010111110111010101110111011101010111
101000101000101010000010000010101000100010101010001
101111101110101011111011111110101011101110101111101
100010001000101010001000000010100010000010100000101
111010111011101010111111111010111111101010111110101
101010000000101010000000001010100000101010001000101
101011111111101011111110111010111010111011101011101
101010100000001010000000100010100010001000100010001
101010101111111010111110101110101111101110101111101
100000100000000000100000100000001000000000100000001
111111111111111111151111111111111111111111111111111

D
