111115111111111111111111111111111111111111111111111
101000001000000000001000100000000000000000000010001
101111101011101110111010101111111110111111111011101
100010001010001000100010100000100010100000001000101
111010111010101111101110111110111010101111101110101
101010000010101000001000100010001010001000001010101
101011111110111011111010111011101011111011111010101
101000000010001010001010001010001010001010000000001
101111111011101011101011101010111010101010111111101
100000000010001000001010100010000010100010100010001
101111111110101111101010111011111010111111101011111
101000000010100010001010001010000010100000001000001
101110111010101110111010111010111110101111111111101
100010101010101000100010000010001010101000000010001
111010101010101011101111101111101010101011111110101
101010100000101000101000101000100010001010000010101
101010101111111011101010101011111011111010111010101
101010100010001010001010100010001010000010100000101
101010101110101010111010111110101011111010111111111
101010101000100010001010000000100010000010000000001
101010111011111111101011111111101110111011111111101
101010100010100000100010001000100000101000000000101
101010101110101110111110111010111111101111111110101
101010101000000010000000100010100000000010001000101
101010101011111111101110101110101011111010101011101
101010001000001000101000101000101010001010101010001
101011101111111010101011101011101110101110101010101
101000100000000010001010001010000000100000100010101
101110111111111111111010111010111111111111111010101
101000100000000000100010101010000010001000001010101
101011101111111110101110101011111010101011101110101
101010001000100010100010100000100000101000100000101
101010111010111010111010111110111111111110111111101
101000100010000010001010001000100000100000100000101
101111101110111111101111101011101110101111101111101
100000001000100000001000001010001000001000100000101
101110111111101111111011111010101111111010101110101
100010100000001000100010001010100010100010101000101
101110101111111010101110111011111010101110101010101
101000101000000010001010000010000010001010001010101
111010101111111011111010111110111110111011111010101
100010100000001010000010000010100010101000100010101
101110111111101011101011111010101010101010101110101
101010100010101000101000001010101010100010101000101
101010101010101110101111101010101110111110101111101
101000001000100000101000101000101040100010100000001
101111111110111111101011101111101011101010111111111
100000100010001000001010001000100010001010001000001
101110101011111011111010111010101111101010101110101
100010001000000000000010000010000000001000100000101
111113111111111111111111111111111111111111111111111

R
