131111111111111111111111111111111111111111111111111
101000001000000000000000000000000000000000100000001
101010101011111111111011111110111111111110101011101
141010101010000000001010000010100000001000101000101
101110101110111111101011111010101111101011101110111
100000100000100000001010000010001000001000100010001
111111111111101111111010111111111011111110101111101
100000100000100010001010100000001010000000101000001
101010111110111010101010101111101010111111111011101
101010000010100010100000100000100010000000000010001
111011111010101111111110111110111111111111111110111
100010001000101000001000001010100010000010000010001
101110101111101011101111101010101010111110111011101
100010100000001010100010100010001010100000101000001
111010111111111010111010111011111010101111101111111
100010001000000010100010001010100010000010000010001
101111101011111010101110101010101111111010111010111
100010001000100010001000100000101000001000101010001
101010111111101110111111111110101011101111101010101
101010000010001010000000000010100000101010000010101
101011111010111011111111111011111110101010111111101
101000100010101000000000001000000010101010100000101
101110101110101011111110101111111011101010101110101
101000100010100000100000100010000010001000101010001
101011111010101111101011111110111110111011101011101
101000001010101000001010000000100000001000001000001
111111101010101011111010111111111110101111111011111
100000101000101000100010100000000010100000101010001
101110101111101110111110111011111011111110101010101
100010100000100010000000100010001000000010100010101
111010111010111011111111101110101111111010101110101
100010001010001010000000001000100000001000101000101
101111101011111010111111101011101111101111101011101
100010000010001010100000101000100000101000001010001
111011111110101011101110101111101110111011111110101
100010000000101000001000101000100010001000001000101
101110111111101111111011101010111011101111101011101
100010001000100000001010100010001000100000100010101
101011101110111110111010101111101110111110111110101
101000100010100010000010101000101000100010000010001
101110111010101011111110101010101011111011111010111
100010100010001000001000000010101000000010001000101
111010101110111011111011111111101111111011101111101
100010100010101010000010000000100000001000001000101
101110111010101010111110111110101111101111101010101
100010100010001000000010101000101000101000101010101
111110101111111110111110101011111010101010101010101
100000100000100010100000101000100010101010101010001
101111111110101011101111101110101110101010101011101
100000000000001000001000000000001000001010000010001
111111111115111111111111111111111111111111111111111

D
