111111111111111111111111111111111111111111111111111
101000000000100000100010000010000000001000000010001
101011111110111010101011101011111110101011111010101
100010100000100010101000001000000000101000001000101
111110101111101110101111111111111111101011101111101
100000100010001010001000000010000000101010100000101
101110111010111011111011111110111011101010111110111
100010001000100000001000000010001000101000100010001
101111101111101011111011111011101110101111101011101
101000001000001000100010001010001000100000001000101
101011101111111110101110111010111011111111111110101
301010000000000000100010001000101000001000000000101
111010111111111110111010101111101110111011111111101
100010001000100000001010100000000010001010000000001
101111111010111111111010101111111011101010101111101
100010000010100000100010100010100010100010100010001
101010111110101110101111111010101110111111111010111
101010001010001000100010000010101000000000100010001
111011101011111011111010111110101110111110101111101
100010101000001000000010100000000000100000101010001
101010101011101111111110111111111111101111101010111
101000101010100000001000001000000000100010001000001
101111101010111011101111101011111110111010111111101
101000001010100010101000001000001010001000100000101
101011111010101110101011111111101011101111101110111
100010100000100010101000000010001000101000101010001
101110101111111010101011101110111011101010101011101
100010101400000010101000100000100010001010100010001
111010101011111110101111101111101010111010111010111
100010001010001000000000101000001010000010001010001
101111101010101111111110101011111011111110111011101
101000101010100000000010100010100000001000100010101
101010111010111110111010111110101111101011101110101
101010001000100010100010100000001000101000000000101
101011101011101011101110101111111010111111111110101
100010101000101000001000101000000010000000100010101
111110101111101111111011101011111111111110101011101
100000100000101000100010001000001000000010001000101
111110111110101011101110111111101011101011111110101
100000001000101000001000100000101010001010000010001
101111101011101110111110101110101010111110111011101
101000101000100010100010100010001010100000100010105
101011101110111010101011111011111110101111101010101
101000100010001010101000100010000000100000101000101
101110111011101010101110101110111011111011101110101
100010000000101010001000101010001000000010001000101
101011101111101011111011101011101111111110101111101
101000101000100010001000001000001000000010101000001
101110111010111110111111111011111110111010111011111
100010000010000000000000000000000000100010000000001
111111111111111111111111111111111111111111111111111

R
