111111111111111111131111111111111111111111111111111
101010000000000010000000000010000000001010000000001
101010101111111110111110111011111010101010101111101
101000100000000000100010001000001010101000101000001
101111111111111110101011101111101110101111101011111
101000000000100010001010001000001000100000101000001
101011111110101011111010111011111011111110101111101
100010100010001010000010100010000010100010001000101
111110101011111011111010111010111010101011111110101
100000101000001000001010001010001010001000000000101
101110101110101111101111101011111010111111101111141
101000100010100010100000001000000010001000100000001
111010111010111010111111111111111111101010111111111
100010100010100000000000000000000000101010001000001
101011101110101111111111111011111110101011101110111
101010001000100010000010001010000010100010100010001
101110111011111110111010101110111011111110111011101
100000100010000000101000100010001000000010001000001
101111101110111111101111111011101110101110101111101
100000101000100000000000001000101000101000100000101
111110101011111011111011101110101011101011111110101
100000101010001010001000100010001000101000100010001
101111101010101110101111111011111110101110101011111
100010001000100000100010001000001000101000101000001
111110101111111111111010101111101011111011101110111
100000100010000000001010100000101000000010000010001
101111111110111111101010111110101111111110111111101
100000100010001010001000100010000000001000100000001
101110101011101010101111101111111111101011101111101
101010001000000010101000100000001000101010001000001
101011111111101110101010101110101011101010101111111
100000100000101000100010100010100010001010101000001
111110101110101011111110111010111110111110101011101
100000101000101000100010101010000000100000101010001
101111101110111010101110101011111111101111111010101
101000100010001010101000001000100010000000100010101
101010111011101110101011111110111010111110101110101
100010001010001000100010001000100010100010001000101
111111101011101010111110101011101110101011111011111
101000001000101010100010101010100010001000101000001
101011111110101011101010101010101011111110101111101
100010000010101010001010100010001000000010100010001
101111101010101010111010111111111111101010111010101
101000101010101000100010000010000000101000000010101
101010101010101111101011111010111110101111111110101
100010101010100000001000001010100010100000100000101
111110101010111011111111111010111010111011101111101
100010001010001010001000001010100010001010001000001
101111111011101110101011101010101111101110111011111
100000000000100000100000100000100000000000100000001
111111111115111111111111111111111111111111111111111

D
