111111111111111111111111111111111111111111111111111
101000000010000000000000001000000000000000000000001
101011111011111011111111101011101110111111111011111
300010001000001010000000101010100010100010000010001
111110111111101011111011101010111011101010111110101
101000000000101000001000001000001000001010001000105
101011101111101111101011111111101111111011111011101
101010100000001000001010100000101000001000000000101
101010111111111011111010101011101110111111111111101
101000100000100010001000101000001000100000001000001
101110101111101010101111101111111011101111101011111
100010100000001000100000100000100000000000101000001
111010111011111111111110111110101111111111101111101
100010001000100000001010100010101000100010001000001
101011101110111110101010101010111010101010111011101
101010101010000010100010001010100010001010104010001
101010101011111010111011111010101111111010101110111
101000101000001010100010100010001000001000100010101
101110101011101010101110101111111011101011111010101
101000101010100010100000100000000010001010000010001
101111101010111110111110111111111110111010111111111
101000001000000000101000100000000010000010000000001
101011111111111111101011101111111111111111111111101
101000100000001000001010000000000000000010000000001
101110101111111010101011111011111011111010111111101
100010101000001010101000001000001000100010100010001
101110101011101010111111101111101110111010111010111
101000100000100010100000101000001010001010100010001
101011111111111110101110101111101011101110101111101
101010000000001000101000100000100000100010100000101
101011101111101010101011111110111111111010101011101
101000101000101010101000000010001000100010101010001
101110101010101011101111111011101010101110101010111
100010001010101000001000001000000010101000101000101
101111111010101011111011101111111110101011101111101
100010000010001000001000101000000010101010001000101
101010111111111011111110101011111010101010111010101
101000100000100010000010100010001010001010100010101
101111101010101110111010111110111011111010101110101
101000001010101000100000100010000010000010001010001
101011111011101010111111111010111110111111111011101
101000001000001010100010000010000000100010000010001
101111101111111011101010101111111111101011111010111
101000000000001000001010101000000000101000000010101
101111111110111111111010111011111010101110111110101
100000100010100000001010001010001010001000100010001
111110101010101111101011101010111011111011101011101
100000101000101000001000100010100010001000101010001
101111111111101011111110101110101110101111101010111
100000000000001000000000100000100000100000001000001
111111111111111111111111111111111111111111111111111

R
