111111111111111111111111111111111111111111111111111
100010100000000000100010001000001000000000000000001
111010101011111110111010101011101011111011111111101
101010001010000010001010101000101000001000000010101
101011111010111111101010101110101111101111111010101
101000100010000000000010100010100000101000001010005
101110101111101111111110111010101110101110101011111
301000101000101000001000101000100010101000101000001
101011101010111011101011101111111011101011101111101
101000101010001000100010100000001000100010001010001
101110101011101110111110101110111110111110111010101
101000101010100010000010000010000010001000000010101
101011101010111011111011111011111011101011111110101
101010000010001000001000001000001000100000100000101
101010111110111110111111101011111010111111101111111
100010100000000010000010001010001010001000100000001
101110101111101111101110111010101110101010101111101
101000101000001000001000100010101000101010101010001
101110111010111011111011111110101011111010101010111
100010001010100010001000001000101010001010100010001
111011101011101110101111101011101010101010111111101
101010101000100000100000001010101010101010000010001
101010101010111111111111111010101010101011111010101
101010101010001000100000000010001010101010001000101
101010101010111010101111101110111010101010101111101
100010001010000010100000101010001000101000100010101
101110111111111010111011101011101110101111111010101
101000000000001010000010001000100010100000100010001
101111111111101011111110111010111011111110101111111
101000001000101000100010101010001000000000100000001
101011101010101111101010101011101111111110111111101
100010100010100000001010100000100010000010000010101
111110111110111111111010111111101011101011111010101
101000000010001010001010100000001000101010001000101
101011101111101010101010101111111110101010101110101
101000100040001000100000100000000010001000100010101
101110111111111111111111101111111011111111111110101
100010100010000000000010100000100010001000000000101
101010101010111111111010111110101110101011111111101
101010001010100010000010001000100000100000100010001
111011111010101110111110111011111111111111101010101
100000001000100010001010000000001000000000101000101
101111101111101011101010111111111011111110101111111
101000101000001000001000100010000010000010100000001
101010101011111111111011111010111110101110101111101
100010101010000000000000001010000010101000101000001
101110101010111111111111101011111010101011101011101
100010101010100000100000100010001010101010001010001
111010111011101110101110111110101010101011111010111
100010000000001000001000000000100010100000000010001
111111111111111111111111111111111111111111111111111

L
