111311111111111111111111111111111111111111111111111
101000000000000000000000000000100000000010000000001
101111111111101111111111111010111110111010111011101
100000001000101000000000100010000000100010101010101
111111101010101111111010101111111111101110101010101
101000100010100010000010100010000000101000001010001
101010111110111010111110111011111011101011111010111
100010000000101010000010001010000010001000100010001
101111111111101010111011101010111010111111101111101
101010001000000010100010101410001010000010001000101
101010101011111110101110101011101011111010111011101
101000101010000010100010101010001010001000100010001
101111101011101011101010101010111011101111101110111
101000001000001000101010001010001000001000100010001
101011111111111110101011111011101110111010101011101
101000100000000000101000001000101000100010001000101
101010101111111111101111101110101111101111111110101
101010101000001000001000100010100000100000100010101
101010101110101011111010111010111110111110111010101
101010100000101010100010000010000010000000001010101
101110111111101010101110111111111010111111101010101
100010100000101010100010100000100010100000101010101
111010101011101010111011101110101111101110101010101
100010001010001000001000101000101000001010100010101
101110111010111111101110101011101011111010111010101
101010101010000000101010101000001010000010100010001
101010101011111110101010101111101011111010101111111
101000001000100010100010100000101000001010101000001
101111101010111010111110111110111111101010101110101
100000101010000010000000100010000000000010100010101
111110101011111111111110101011111111111110111010101
100010101000000000000010101000001000100000100010101
101110111111111111111010101110111010101111101110101
100010000000100010001000100010100010101000100000101
101011111110101010101011111110101110101110111111101
101000000010101000101000000000101010100010001000101
101111101110101111101111111111101010111010111010101
101000100010001000101000000000001000100010000010001
101110111011111010101011111111111011101111111111111
100000001000000010100010000010001010100000100000001
111111101111101110111111101110101010101110101111101
100000001000001010100000001000100010101010001000101
101111111011111010101111111011111110101011111010101
101000000010000010100010000010000010000000001010101
111010111110111110111010111111101110111111111010101
100010100010000000000010100000100000100000001010101
101111101010111111111110101110101111101111101010101
100010001010000010001000101010101000101010001010101
101010111011111110101011101010111010101010111010101
101000001000000000100000001000000010001000000010001
111111111111111111111115111111111111111111111111111

D
