111115111111111111111111111111111111111111111111111
101000001000100000100000000010000000001010001000001
101011101110101110101111101011101111101010101010111
100010100010001000100000101000101000001000100010001
111110111010111011101111101110101111101111101111101
100010000010001000001000001000101000100000100010101
101010111110111110111011111011101010111110111010101
101010100000100010001010000000101010001000100000101
101010111111101011111011111110101011101011111111101
101000100000101000001010000010100000101000100000101
101111101110101111101010111010111110101110101110101
101000001000100000101000100010100010101000001000101
101110111011101110101111101110101010101111111110101
100000100010101000101000001010101010100000000010001
111111101110101011101011111010101011101111111011101
100000100010101010000010100010001000100010001000101
101011111010101011111110101011111110111110101110101
101000001010001000000010001010000010000000100000101
101110101011111011111011101010101111111111111111101
101000101000001000001000101010100000000000001000101
101011111111101110111110101010111111101111101011101
101010000000001000100010101010001000001000100010001
101010111111111111101010111011101011111010111110111
101000100000000000001000100010101000000010000010101
101111111011111111111111101010101111111111111010101
100000001010000010000000001000100000000010001010001
111111101011111010101111111110111111111010101011101
101000001000100010101000001000000000001010101000101
101011111110101110101011101111111011111010101011101
100010000000100000100010100000001010000010100010001
101111101011111111111010111111101110111110111010111
101000101010000000001000100000100000100010001010001
101010101110111111101110111010111111101111101111101
100010100000000010101000000010100000100000100000101
111110111111111010101111111110101110101011111110101
100010000010001010100000100000100010101000001000101
101011111010111010111110101111111010111110111010101
101000100010000000001000101000000010001000100010101
111011101111111111111011101110111111101010101111101
100010001000000010000010101000100000000010101000001
101110111011111010111110101011101111111110101011111
100010001010100010001000001000101000001000100010001
111011101010101110101011111010111011101011111111101
100010101010100010101010001010000000101010000000001
101010101010111011101011101011111110101010111111101
101000101010001010001000100010000010101000100000101
101111101010111010111110111110111010101111101011101
101000100010001010101000100010101010100010101000101
101010111110101010101011141010101011111010101110101
100010000000100000100000001000100000000010000010001
111111111111111111111111111111131111111111111111111

D
