111111111111111111111111111111111111111111111111111
100000001000000010000000000000101000100000000000101
111111101010111011111111101110101010101111101110101
100000101010101010000000101000001010000000100010001
101110101010101010111110101111111011111111111011101
101010101010100010100000100000100010001000001000101
101010101010111010111011111110101110101011101010101
101000101010001010001000000000101010100010001010101
101111101111101011101110111110101010111110111010101
100000100000101000101000100010100010001000001010101
111110111110101110101111101011111011101111101010111
100000100010001000100010001000100000100010101010001
101110111011111011101010111110101111101010101111101
101000000010000010101010100010001000101010100000001
101111111110111110101010101011111010101010111111101
100000001000100010001000101000100010101010100000001
101111101011101011111110111011101110111010101111111
100010001000001000100010000010001000100010100000101
101110101111111110101011111010111011101110111110101
101000101000100010001010000010001010001000000010101
111011111010101011111011111011101011101011111110101
100010000010101000100010001010001010001000000010101
101110111110101011101110101010111010111011111010101
100000100010001000101000101010001010001010001000101
101111111011111110101010101111101010101011101111101
100000001000000010101010101000101010101000001000001
111111101011101010101010101010101010101111101011101
101000001000101010001010100010001010100010001000101
101011111110101011111110111111111011111010111011101
101000001000101000000000100000001000001010001010001
101111101011101111111111101011111111101011101110101
101000101010100010001000001000000010001010000000101
101010101010111010101110111111101010111011111111101
100010001000001000100010000010001010101000000010001
101111111111111110111011101110111010101011111011111
100010000000000010101010001000100010100000001000001
111010111111111010101010111011101110111111111111101
101010100000000010001010001010101010001000000000105
101010101111111111111011101010101011101011111110101
100010100000000000000010001010001000100010100000101
101110111111111111111110111010111110111110101111101
100000100000000000001000100010000000100000101000001
111111101011111111111011101111111011101011101110111
300000001010000000001000100000001010001000100010001
111011111010111111101110111111101110111110111011101
100010000010101000000010001000101000101000001000001
101110111110101011111011101110101011101011111111101
101000000010101000001000100010100010001010000000101
101111111110101111101111111010111110101010111110101
100000000000000000140000000000000000101000000010001
111111111111111111111111111111111111111111111111111

R
