111111111111111111111111111111111111111111111111111
100010000000000000000010100000100000001000001000101
111011111111111011101010101011101011101011101010101
101000000010001010001010001000001010001010101010101
101111111010101010111010111111111010111010101010101
100010001000101010101010100000100010100010100010001
101110101111101010101011101110101110101110111111101
100000100000101010100010001010101010101010000000001
101111101110101110101110111010101010101010111111111
100000100010100010101000100010001010001000100010001
111110111011111010101011101111111011111011101010101
100000100010000010100010000000001000001010001010101
101111101110111110111110111111101011101010111010101
501000100010100000100010000000101000101000101000101
101110111010101011101111111110101110101111101111101
100000101010101010000000001000100000100000100000101
111110101010111011111010111011111111111011101011101
100000001010001000001010001010000000001000001000001
111111111011101011101111101010111111101111111111111
100000100010001000100000101000100000100010001000001
101110101010111111101110101111101110111010101011101
101010101010000000101000100000101010100010100010001
101010101011111110111011101110101010101110111110101
101000001000001010100010100010100010001010100000101
101111111111101010101110101110111011111010101111101
100000001010001010101000001000001010000010100010001
111111101010111010101011111011101010111010111010111
100010001010100010101010000010001010001010101010001
101010111010111010101010111110111011101010101011111
101010100000000010001010100010101010001010001000001
101010101111111111111010101010101010111011101111101
101000101010000010001010101010001010101010101000103
101111101010111010101010101011101010101010101110101
101000001010001000100010001010001010101000100010101
101111101011101111111111111011111010101110111010101
100000101000100000100000001000000010100010001010101
111110101110111110111010111111111110101110111010101
100000100000100010001010100000001000100000100000101
101111111110111011101110101111101010111111101111101
101000000010100000101000100010101010000000001000101
101110111110101111101011111010101011111111111010101
100010100000101000101000000000100010000010000010001
111010101111101010101110111111111110111010111111101
100010000000100010100010100010001000100010001000101
101111111110101110111011101010101011101111101010101
101000000010100010001000101000100010101000101010001
101011111010111111101110101111111110101010101110111
100010001010000000000010001010000000101010100010101
101111101011111111111111111010111011101010111010101
100000001000000000000000000000001000000410000010001
111111111111111111111111111111111111111111111111111

L
