111111111111111111111111111111111111111511111111111
101000000000100000001000000000100000100000000000001
101011111110101110101111101110111110101111101111111
101010001000100010100010001010001000100000101000001
101010101110111110111010111011101011111011101011101
101000100010000010101000100010001010000010001010101
101111101011111010101111111010111010111110111010101
100000101000101010100000000010100010000010100000101
111110111010101010101111101010111010111110101111101
100010001010101000101010001010100010100010000010001
101011101110101111101010111110101110101010111110101
101010001000100000101010000000100000101010100000101
101110111011101111101011111111101111101011101111101
101000100000100000100010100010001000101000101000101
101011111110111110111010101010111010101110101110101
101000000000100000001010001000100010100010001000101
101111111111101111101011111110111010111011111011101
100000000000101000001000000010001010100010000010001
101111111010101111111111111011101110101110111110111
101000100010001000000010000010000000101000000010001
101110101111111011101110111111111111101111111011101
101000100000000010001000100000000000001000000000101
101011111111111110111011101111111111111011111110101
101000000000000010001010001000001010000000000010101
101111111110111111101010111011101010111111111011101
100000000010000000100010001010101010000010001000101
111111111010111011111110101010101011111011101110101
100000100010001010001000101010101000001000101000101
101110101111101010101011101010101111101110101010101
101000101010001010100010001000100000101000101410101
101011101010111010111110101110111110101011101011101
101000001010101000100000100010101000101010001000001
101111111010101111101111101110101011101011101111111
101000000010100000100010001000101000100000000000101
101111101110111010111010111011101110111111111110101
100000100000000010100010001010000010001000000010101
111110111111111011101111101010101011101011111110101
100000100000101010001000001010101000101010000010101
101111101110101010111111111011101011101010111010101
100010001000100010001000001000001010001010101000101
111010111110111011101011101110111110111010101111101
101010000010001000100000100000100000101000100010001
101010111011101111111111111111101111101011111010101
101010100010001000000000000000001010000010000010101
101011101110111011111111111111111010111110101110101
101000100010100000001010000000001000100000100000101
101110111010111111101010111011111011111110111111101
100010001010000000001010001000001000100010001000001
101111101011111111111011101111101110101011111011101
100000000010000000000000000000100000001000000010001
111111111111111111111113111111111111111111111111111

D
