111111111111111111111111111111111111111511111111111
101000000000100000000000001000100000000000000000101
101110111110111110101111101010101111111110111110101
100000100000100010100010000010101000000010001000001
111111101111101010111011111110101011101111101111101
100000101000001010001000001010100010001000100010001
101110101110111011111011101010111111111010111010111
101010100010100000001010001010000010000010001010001
101010111010111111101110111011111010111111101011101
100010001010000000100000100010100010001000001010001
111010101011111110111111101010101110101110111010111
100010101000000010100010001000100010100010100010001
111110111111111010111010101111111010111010101011101
100010000000001010001000100010000010001010101010101
101011111110101011101110111010111111111010111010101
101000000000101000100010100010000000100010000010101
101111111011111110101010101111111110141111111110101
100010100010000010101010100000000010100010000000001
111010101110101110101011111110101110111011111111111
100010101000100010101010000010100010001000000000001
101110101011111010101010111010111011101111111110101
101000001000101000101000101010001000100000000010101
101111111110101111101111101011111110111111111011101
100010001000100000000000101000000010000000001010001
101010101011111111111110101111111010111111101010101
101010101010000000001000100010001010000000101000101
101010101010111111101011101011101010111110101111101
101000101010101000001000001000001010101000101000101
101111101010101011111111111110111010101011101110101
100010001000101010000010001000100010001000100000101
111110101111101010111010101011101111101110111111101
100010101000000010100010100000101000100010000000001
101010101011111111101010111111101011111011111111111
101000101010001000001010001000101000001010001000001
101111101010101110111110111010101011101010101011101
100000101000100010001000100010001010100010100000101
111110111111111010101011101111111010111111111111101
100000100010000010100010101000001000100000000000001
101111101010111110111110101111101110101011111111101
101000001000100010001000100010000010101010100000101
101011111111101111101011111010111110111010101110101
101010000000001000101010000010000000100010000010001
101011111011111010101010111110111111101111111011111
101010001000001010000010100010100010000000001010001
101010101111101011111110111010101011111111101011101
101000100000100010000000100010001010000000001000101
101111111110101110111111101111111010111111111110101
101000001000100010001000001000000010000010000010101
101010111011111111101011101011111111111010111010101
100010000000000000001000100000000000000010001000001
111111111111111111111111111111111111111111131111111

U
