111111111111111111111111111111111113111111111111111
101000100000001000000000001000100000001000000010001
101010101111101010111111101010111110141111101011101
100010101000101010100000100010000000101000001000001
111110101010101110101110111111111111101011111111101
100010100010100010101010000000000000101000100000101
101010111010111010101011111111111110101110101111101
101010001010101010101000100010100000100000100010001
101011101110101010101010101010101111111111101010111
101000100010100000100010101010101000000000101000101
101110111010111111111110101010101011101110101111101
101010001010000000100010001000100010100010100000101
101011101010111110101111111110111110111010111110101
101000001010100000100000100000100000001010001010101
101111101011101111101110101111101111101011101010101
100000101000001000100010001010000000101010001010101
101110111111111011111011111010111110111010111010101
100010100000100010000010000000001000100010000010101
111110101011101010111110111111111011101011111010101
100000101000001010100010100000100010001010001010101
101110101111111010101110101110101010101110101110101
101000100000101010100010101010101010101000100000101
101111111110101010111010101010101110111011111111101
100000000010101010001000100010100010001010000000001
101111101010101011101011101110111011101010111111101
100010001010001000101000101000001000100010000000101
111110111111101011101110111011111110111110111110111
100010001000101000001000100010000010000000000010001
101011101010101111111110101110111011111111111011101
101000100010101000000010001000101000000010001000101
101110101110101111101011111011101111111010101110101
101000100010101000101010001010001000000010100010101
101110111110101010101010101011101011111110101110101
100010001000100010001010101000101000000010100000101
101011101011111111111010101010101111111011111011101
101010000010000000001000101010100000100000001010001
101011111110111110101111101010101111101111101110101
101000001000100010100000101010100000001000100000101
101111101011101010111111101010111111111010111111101
100000101000101010001000001010100000000010100010001
111110101110111011101011111010101111111110101110111
100010100000000000101010001010000000001000101000101
101011111111111111101011101011111111101011101011101
101000000000000000001000100010000010001010001010001
101111111111101111111110111110111011111011101010101
100010000010001000000010001000101000100010001010101
101010111010111011101111101011101110101110111011101
101000101010001010100000101010000000101000100010001
101111101011111010111011101010111111101010101110101
100000001000000000001000000010000000001010000000101
111111111111111111111111111115111111111111111111111

D
