111111111111111111111111111511111111111111111111111
100000100000000000000010000010000000000000100000001
111110111011111110111011111010111111101111101110101
100010001000000010001000001000000010101000000010101
101111101011111111101111101111111010101011111110111
100000101010000000101000100010100010100010000010001
101010101010111110101011111010101110111110111011101
101010101010100010001000001010101000000010001000001
101011101010101111111110101010101111101111101111101
101010001010101000001000101010000010001000100010001
111010111110101010101011101011111010111010111010111
100010000000100010100010001000001000100010000010001
101111111111111110101111101111101110101111111111101
100000000000000000101000101000001000101000100000101
101011111011111011111010111011111111101010101011101
101000100010001010001010001000100010001010001010001
101110111110101110101011101110101010111111111010111
100010100010100000100010000010001010001000000010001
111010101010111111111110111011111011101011111111101
101010001000000000000010001010001010001000100000001
101011111111101111111011101010101010111110101111111
100010000000101000001000101000101000100000100000101
111110111110111011101110101111111111101110111110101
100000100000000010101000101000100000100010000010101
101011111111111110101111101010101010111011111010101
101010000000100000000000100010001010001010000010101
101110111110111111111110101111111011101010111110101
100010001010000000100010101000001000100010001010001
101011101011111110101110111011101010111111101011101
101000100000100010100000001010001010100000100000101
101110111110101110111111101010111110101110111111101
100010100010100010100000100010000000101010000000001
111010101010111010101110101111111111101011111111111
100010001010100010001010101000000000001000100000101
101111111010101111111010111011111111111010101010101
100010001000100000000010000010000010000010101010101
111010101111111011111011111111111010111110101010101
101010100010000010001010000000001000100010001010001
101011101010111110101010111111101011101011111011101
101010001010001010100010001010001010001000101000101
101010111010101010111110101010111011111010101110101
100010001010101010000010101010001000001010100010101
101111101011101011111011101011101111101010101010101
101000001000101000001000001000100010100010001010101
101010111110101011101111111011111010101111111110101
101010000010001010000000000010000010001000000000101
101111111011111011111111111110111111111011111111101
100000001000100010001000000010001000100010000000101
111111101110101110101011111011101010101110111110101
100000000040100000100000001000000010001000000010001
111111111111111111111111111111111113111111111111111

L
