111111111111111111111111111111111111111113111111111
101000100000000010001000000000000000100010000000001
101010111011101010101011111110111111101010101111111
100010001000101010100000001000100010001000100000001
111111101111101011111111101011101010111111111111101
100000001000001010001000101010001010001000100000101
101111111011111010101110101010111011101010101110101
101000001000101010100010001010101000001010001000401
101011101110101010111011101010101111111011111111101
100010100000100010100000101000100000001010000010101
111110111111101110111110101111101111101010111010101
100000000010001000001000100000100000101000101010101
111111101010111111101011111110111011101111101010101
100000001010000010001000000010101010000010001010001
101011111111111010111111111010101010111010101010111
101010000010000010000000100010100010100000101010001
101110111010111111111110101110101110111111101011101
100000101000100000001000101010100010001000101010001
101111101111101111101011101010111110101110101011101
100000100000001000100010001000000010100010001000101
111110101110111010111110111111111011111010111110101
100010101010001010001010000010100010000010100000101
101110101011101011101011111010101110111110101111101
100000100010101000101000001010000000100010101010001
101111111010101110101011101011111111101110101010111
100010001000100000101010001000001000000000101000101
111010101110111111101010101111101011111111101011101
101010100000100000101010100010001000000000101000101
101010111111111110101010111110111111111011101110101
100010000000001000101010001000100010000010001000001
101111111111101011101111101011101011111010111111111
100000100010000010001000001000001000001010000000001
111110101011111110111011111111111111101111111111101
101000101000001000100000100000001000100010000000001
101011101111101011101110101011101110111010111111101
100010001000100010101010001000101000001010000010101
101110111011111110101011111110101011111011111010101
101000100000100000100000100010100010001000100010001
101011101110101110111110101010111110101110101110111
100010000010100010100000101010000000100000101000001
111110111110111010101111111011111111111111101111101
100010100000001010001000000010100000100000001000101
101010101111111011111011111010101110101111101010111
101000101000100010000000101010001000100010100010001
101111101010101111111110101010111011111010111111101
100010001010001000000010101010001000000000000010101
111010111011111110111010101011101111111111111010101
100010001010000010001000101000100010001000001000101
101111101011101011101111101110111110101011101111101
100000100000001000001000000000000000100010000000001
111111111111111111111111111111151111111111111111111

L
