111111111111111111111111111111111111111115111111111
100010000000001000001000000000101000000000000000001
111011101111101110101111101110101010111111111111101
101000101000100010100000101000100010100010000010001
101110101011111010111110101110111010101011111010111
100010001000001000100010100010001010101000000010001
101011111110111111111010111011101110101111111011101
101000000010000000000010000010100000100000001000101
101111101011101010111111111110111111101111101011101
101000101000101010100000100010000000101000101010001
101010101110101011101011101010111110101011101110111
101010001000101000001000001010001010000010001000101
101011111011111011111111111011101011111110101011101
101010100010001010000000001000101000100000101010001
101010101110101011111110111011101011101111111010101
101010101000101000000000100010001010001000100010101
111010101011101111111111101110111010111010101111101
100010001000101000001000100010001010000010001000001
101110111110101011101010111011101011111111111110101
101000100010100010000010001000100010100000001000101
101011101010111111111111101011111010101110101011101
101010001000100010000000101000100010001000101010101
101010111111101010111110101110101111111011101010101
101000100000101010100010101000101000001010001010001
101110101110101010101110101011101110101010111010111
101010100010001000101000101010001000100010000010001
101010111011111111101011101010111011111111111111101
101000001000100000101010000010100010001000000000101
101111111110101110101010111110101110101011111110101
100000100010001000001010100000100000101010000010001
101110101011111011111010101111111110101110111011101
101010001000001010100010100010000010100010001000101
101011111011111010101110111011101011111011101110111
100010000010000000101010101000001000100010001010001
101110101110111111101010101111111114101110111011101
101000101000101000001000000000001000100010001010001
101011111011101011111111111111101011111011101010111
101010001000101000100000001000101010001000101010001
101010101110101110101111101010101010101011101011101
101000100000100010101000100010101000101000000000101
101111111111101010101010111110101111101111111110101
100000100010001010100010001000100010001000000010101
111110101110111010111110111011111110111011111011101
100010100000100010001000100010000000100010001000001
101110101111101011101011101010111111101010101111101
100000101000001000100010001010000010001010100000001
101111111011111110111110111111111011101010111111111
101000001010000010100010000000001000101010001000001
101110101010111010111011111011111110111011101110101
100000100010001000000000001000000000000010000000101
111111111111111111111111111111111113111111111111111

U
