111111111111111111111111111111111111111311111111111
101010000010000010000010000000000000001000000000001
101010101011101011101011111111111011101011111111101
101000101000101000001000100000001010100010100000001
101011101110101111111110101111101010111110101111111
101010001010101000000010101000100010000000100010001
101110111010101011101110101010101111111010111011101
100000100010001000101000101010001000001010001000101
111111111011111110101011101111111011101011111110101
100000000000001000101010001000001010101010000000101
101110111111101111101011101011101010101010111111101
100010000000101000001000101000101010101000100000101
111011111110101011101110101011101010101011101010101
101000000010100010000010101010001010101000101010101
101011111110111111111010101010101010101110101010101
100010000010000000101010100010101000100010101010101
101110111010111110101010111110101110111010111010101
101010100010100000100010100000100010100010000010101
101010111011101111101110101111111110101111111110101
101010001000001010001000100000000010101000000010101
101011101111111010111011111111111010101110101110101
100000101010001000101000000000001010100010101000101
111111101010101011101111111111101010111011101011101
100000101000101000000010000000101010001000100010001
101110101110101111111010111111101011101110111010101
101010100010100000000000100000001000000010001010101
101010111011111111111110101111111111111011101011101
101000000010000000000010100010001000101000101000001
101111111010111111111011111010101010101110101111101
101000100010001000001010000010101010101000101000101
101010111011101010111010111110101010101011101010101
100010001000101010100010100000101010101010001010101
101111101110101110101110101111101010101010111011101
100010100010101000100010101000100010101010001010001
111010111011101011111010101011111110101011101010111
100000100010001000001000101000000010100000101000101
101111101010111111101111101110111110101111101011101
100010001010100000100000000010100000101000001010001
111110111010101110101111111010101111101011111010101
100000101010001000101000001010001000001000001010101
101111101011111011101110101010111111111111101010101
100010001010001010000010101010000000000010001010101
111010101011101011111010111011111111111010111011101
100010101000001000100000100010100000100014100000101
101110101111101110111110101110101011101110111110101
100010100000000010000010100010001000100010001000101
101011111111111111111011111010111110111011101011101
101000100000000010001010001010001010000010001000101
101110101111111010101010101011101011111110111110101
100010000000001000100000100010000000000000100000001
111115111111111111111111111111111111111111111111111

D
