111111111111111311111111111111111111111111111111111
100000100000001000000000000000000000001000100010001
111110111110111011111111111111111110101010101011101
100010000010000010000000100000000010100010001000001
101011111010111110111110101111111010111111111111101
101000001010100010100010001000001000100000100000101
101111111011101010111011111011101111101110101111101
100000001000001000100010100010100000100010001000001
101111101111111111101010101010111110101011101011111
101010000010000000101000101010000000101010101010001
101010111110111010101110101011111011101010101010101
101010001000100010100010101010001010001010101010101
101011101011101110111010101010101011111010101010101
100000101010101000100010101000101000000010001010101
111111101010101011101110101111101111111110111010101
100000100000101000101010100000100010000000001010141
101110111111101110101010111110111011101111111010101
100010000000001000001000100010101000100010000010101
101011111110111111111011101110101110111010111110101
101010001000100010001000001000100010001010100000101
101010111011101010101111101011111011101110101110101
101010000010001000100010101000100000100000100010101
101011111110111111111010101110101110111111101110101
101000100000100000100010001000100010100010001000101
101110101111101110101111111011101011101010111011101
100010101000000010100010000010001000001010001010101
111010101111101110111010111110111111111010111010101
100010100000101000101010100000001000001010100010101
101110111110111010101010101111111011101010101110101
100010100010100010001010100010000010001000101000001
101110101010101111101010111110111110111110101110111
101000101010001000001010000000100010000010100010001
101011101010111111101011111111101011111011111011101
101000001010100000101000000000001000001000100010001
101111111010101110111111101111111111111110101110111
101000001000100010000000101000000000000010101000101
101110101111111011111110101011111111101010101011101
100000100000001000100000001000000010101010001000101
111111111111101110101111101111111010101111111110101
100000000000000010101000100010001000101000000010101
101111111111111110101010111010101110101011111010101
100010000000100000101010100010100010100010001000101
111011101111101111111010101110111010111110101111101
101000100000100000100010101000101000100000100000001
101110101110111110101110101011101111111111101011101
100010100010000010000010101010000000001000101000101
101010111111101011111110101011111110101010111110101
101010100000101000001000101010000000101010000010101
101110101110111110101011111010111111101011111010101
100000001000000000101000000000100000000010000000101
111115111111111111111111111111111111111111111111111

D
