111111111111111111111111111111111111111111111111111
101000001000000000001000000000100010000010000000101
101011101011111010111011101110101011101011111010101
101010001000001010100010001010001010001000000010105
101010111111101011101110111011111010111111111110101
101010001000001010001000100010001000100000000010001
101111101011111010111011111010101111111111101011101
101000100010001000001000001000100000000010001010101
101010111010111111101111101111111011111010111010101
101010001000100010100010100010001000001000100000101
101011101011101010111010111010101011101111111011101
100010001010001010001000101000101000100000001010001
111110111110111010101110101111101111101111101110111
100010000000101010100010000010001000100010001000101
101111111111101011111010111110111010101110111011101
101000001000001010001000100010000010101000100010001
101010111010101010101011101011111110111010101110111
100010001010101000101000101000000010100010100010001
101111101010111111101110101111111010101110111011101
101000100010100000001000101000001010100010101010001
101010111110101111111111101011101010111010101010111
100010001000100010000000001010100010001010001010001
111111101011111011101111111010111111101011111011101
100010001000001000100010001010000000001000100010001
101110111110101110111010101011111110111010101110111
100000000010100010000010101000100010100010001000001
101111111110101111111110111110101010101111111011101
101000000000101000000010000010101000100010000010001
101011111110111011111010101010101111111011111110101
301000100010100010001000101010001000001000100000101
111110101010101110101111101111111011101110101111101
100000101010101000101000100000001000100010101000101
101111101010101110101110111111101010111010101010111
100010001010100000100000101000101010001010101010001
111010111011111011111110101010101011101110101011101
100010001000000010001000001010001010100000101010101
101011101111111110101111111011111010111111101010101
101000100000100000100010001010001000001000001000101
101111101111101111111010101010101111101011111110101
101000001000101000001010101010100000101000000000101
101011111010101111101010101010111110101111111111101
100010001010001000100000101010000010100000100000001
101110101011101010111111101011111010111110101111101
101000101000101010000010040000001010000000101000101
101011101110111011111011111111111011111111101010101
101010001000100010001000000010000010000000101010001
101010111011101111101111111010111110111110101011111
100010001000001000000010001000100010001000101000001
111111101111111110111010101111101011101011101111101
100000000000000000100000100000001000001000001000001
111111111111111111111111111111111111111111111111111

U
