111111111111111111111111111111111111111111111111111
101000100010000000001000000000000010001000000010001
101010101110111011101111111011101010101011101010101
100010101000100010000000001010001010101010001010101
111110101011101111111111101110111010101110111010101
101000100000100000000010100010101000100000100010101
101011111111111111111010111010101111111111101110101
101000100000000000001010001000100000101000001000101
101110101111111111101011101111111010101011111011101
101000100010100000100010001000000010101000000010101
101011111010101110111110101110111110101111111110101
101000000010000010001000100000100010001000001000101
101111111110111110111010111111101111101110101010101
100000000010100010100010001000000000000000101010001
101111111010101010101111101011111111111111111011111
100000001000101000101000101000001000000010001010001
111110111111101111101011101111111011111010101010101
500010100000101000101010001000000010100010101010101
101011101110101010101010111011111110101110101011101
101000001000100010101010000010000000101000100010001
101111111011101110101011111110111110101011111110111
101010001010001000100000100000001000100010000010001
101010101011111010111110101111101111111110101110101
101000101000000010000010100010100000000010101000101
101011101111111110111110111010111110111010111011101
101000100000000000100000100000000010100010100000101
101110111111111011101111111111111110101110101111101
101000100000001010001000000000000010101000101000103
101111101111101110111011111111111010101010101010101
100000100000100010000010000000101000101010101010101
101110111114111011111110111010101111101011101010101
100010000010100000100010001010000000101000101010101
111011111010101110101011111011111111101110101010101
101000101000100010101000000010000000001000101010001
101110101111111010101111111010111111111011101011101
100010100000001010001000001010000000001000001010001
111010111110101011101111101011111111101011111010111
100010000000101000101000100000000010001000101010101
101111111111101110111010111011111110111110101010101
101000000000100010000010001010000000100010001010001
101011111011111011111111101010111111101011111011111
101010001000100010000000101010000000001000001010001
101010111110101111111010101111111111111111101010101
101000100000100000100010100000001000000000101000101
101110101111111110101110111111101011111010101011101
100010100000000010001000100000100010000010101010001
111010111110111111111011111010111110111111101110101
100010100010100000100010001010001000100000101000101
101110101010101110101110101111101011101110101011101
100000001010000010000000100000001000000010000010001
111111111111111111111111111111111111111111111111111

D
